Team,G,MP,FG,FGA,FG%,2P,2PA,2P%,3P,3PA,3P%,FT,FTA,FT%,ORB,DRB,TRB,AST,STL,BLK,TOV,PF,PTS,PTS/G,Team_ID,Date
arizona,34.0,,904,1976,.457,749,1494,.501,155,482,.322,636,871,.730,412,894,1306,537,255,192,510,496,2599,76.4,1112.0,2000.0
auburn,34.0,,874,2118,.413,647,1423,.455,227,695,.327,448,684,.655,533,802,1335,438,247,110,450,582,2423,71.3,1120.0,2000.0
gonzaga,35.0,,965,2014,.479,705,1299,.543,260,715,.364,529,795,.665,409,916,1325,587,202,150,469,651,2719,77.7,1211.0,2000.0
iowa-state,37.0,,1038,2140,.485,848,1622,.523,190,518,.367,632,899,.703,452,970,1422,565,277,119,518,566,2898,78.3,1235.0,2000.0
kentucky,33.0,,793,1873,.423,605,1230,.492,188,643,.292,506,735,.688,473,827,1300,427,201,185,502,537,2280,69.1,1246.0,2000.0
louisiana-state,34.0,,915,1880,.487,719,1322,.544,196,558,.351,552,858,.643,448,925,1373,503,313,180,593,549,2578,75.8,1261.0,2000.0
maryland,35.0,,1001,2151,.465,806,1598,.504,195,553,.353,486,710,.685,476,878,1354,667,355,235,570,638,2683,76.7,1268.0,2000.0
michigan-state,39.0,,1018,2148,.474,765,1479,.517,253,669,.378,600,816,.735,521,1000,1521,602,256,105,569,721,2889,74.1,1277.0,2000.0
oklahoma,34.0,,917,2004,.458,654,1317,.497,263,687,.383,449,632,.710,443,811,1254,525,241,89,435,643,2546,74.9,1328.0,2000.0
purdue,34.0,,849,1914,.444,643,1325,.485,206,589,.350,601,879,.684,473,752,1225,482,261,104,505,597,2505,73.7,1345.0,2000.0
st-johns-ny,33.0,,699,1671,.418,483,1059,.456,216,612,.353,429,602,.713,431,702,1133,443,352,89,399,531,2043,61.9,1385.0,2000.0
syracuse,32.0,,876,1869,.469,705,1386,.509,171,483,.354,477,677,.705,440,759,1199,564,286,167,448,506,2400,75.0,1393.0,2000.0
texas,33.0,,876,1870,.468,691,1381,.500,185,489,.378,523,810,.646,431,865,1296,481,244,168,515,594,2460,74.5,1400.0,2000.0
ucla,33.0,,952,1984,.480,747,1432,.522,205,552,.371,383,652,.587,447,805,1252,545,282,145,549,626,2492,75.5,1417.0,2000.0
utah,32.0,,782,1624,.482,560,1050,.533,222,574,.387,466,648,.719,326,751,1077,496,198,89,462,586,2252,70.4,1428.0,2000.0
wisconsin,36.0,,765,1793,.427,558,1191,.469,207,602,.344,420,617,.681,298,809,1107,478,236,102,408,658,2157,59.9,1458.0,2000.0
cincinnati,33.0,,898,1871,.480,733,1412,.519,165,459,.359,599,854,.701,405,872,1277,513,236,223,448,566,2560,77.6,1153.0,2000.0
connecticut,35.0,,956,2071,.462,772,1594,.484,184,477,.386,515,707,.728,506,867,1373,529,230,179,495,596,2611,74.6,1163.0,2000.0
duke,34.0,,1045,2172,.481,761,1430,.532,284,742,.383,618,833,.742,453,860,1313,584,333,191,480,552,2992,88.0,1181.0,2000.0
florida,37.0,,1104,2299,.480,838,1567,.535,266,732,.363,628,885,.710,538,914,1452,611,365,141,607,750,3102,83.8,1196.0,2000.0
illinois,32.0,,834,1925,.433,603,1273,.474,231,652,.354,525,763,.688,397,780,1177,499,297,119,458,619,2424,75.8,1228.0,2000.0
kansas,34.0,6825.0,1044,2269,.460,885,1806,.490,159,463,.343,429,660,.650,564,941,1505,630,312,187,589,725,2676,78.7,1242.0,2000.0
miami-fl,34.0,,849,1971,.431,717,1531,.468,132,440,.300,516,690,.748,489,793,1282,498,286,126,504,615,2346,69.0,1274.0,2000.0
north-carolina,36.0,,1014,2066,.491,845,1574,.537,169,492,.343,518,740,.700,436,958,1394,609,210,178,536,580,2715,75.4,1314.0,2000.0
ohio-state,30.0,,797,1748,.456,652,1292,.505,145,456,.318,443,629,.704,381,745,1126,387,194,200,377,521,2182,72.7,1326.0,2000.0
oklahoma-state,34.0,,933,1946,.479,717,1387,.517,216,559,.386,538,768,.701,393,918,1311,642,260,122,484,578,2620,77.1,1329.0,2000.0
pepperdine,34.0,,929,2094,.444,692,1406,.492,237,688,.344,386,577,.669,420,875,1295,494,319,99,504,659,2481,73.0,1337.0,2000.0
seton-hall,32.0,,807,1865,.433,557,1180,.472,250,685,.365,431,636,.678,431,780,1211,458,225,198,476,551,2295,71.7,1371.0,2000.0
stanford,31.0,,819,1750,.468,574,1137,.505,245,613,.400,564,794,.710,399,910,1309,539,141,167,450,518,2447,78.9,1390.0,2000.0
temple,33.0,,790,1913,.413,516,1126,.458,274,787,.348,406,619,.656,497,790,1287,471,312,140,324,459,2260,68.5,1396.0,2000.0
tennessee,33.0,6675.0,909,2019,.450,643,1283,.501,266,736,.361,545,798,.683,480,834,1314,481,290,193,520,618,2629,79.7,1397.0,2000.0
tulsa,37.0,,1050,2223,.472,786,1459,.539,264,764,.346,610,865,.705,480,910,1390,631,433,175,571,730,2974,80.4,1409.0,2000.0
jackson-state,33.0,,766,1875,.409,675,1513,.446,91,362,.251,582,911,.639,528,815,1343,414,252,172,627,673,2205,66.8,1238.0,2000.0
creighton,33.0,,819,1717,.477,530,1023,.518,289,694,.416,483,671,.720,315,769,1084,510,262,77,484,605,2410,73.0,1166.0,2000.0
louisville,31.0,,849,1823,.466,684,1320,.518,165,503,.328,406,577,.704,382,663,1045,518,286,136,490,569,2269,73.2,1257.0,2000.0
central-connecticut-state,31.0,,832,1845,.451,684,1429,.479,148,416,.356,470,665,.707,443,819,1262,451,276,156,479,554,2282,73.6,1148.0,2000.0
st-bonaventure,31.0,,767,1716,.447,590,1204,.490,177,512,.346,425,643,.661,431,700,1131,386,257,87,488,560,2136,68.9,1382.0,2000.0
southeast-missouri-state,31.0,,748,1680,.445,555,1122,.495,193,558,.346,465,662,.702,346,794,1140,383,188,164,478,542,2154,69.5,1369.0,2000.0
iona,31.0,,846,1877,.451,699,1450,.482,147,427,.344,604,833,.725,444,828,1272,529,233,216,557,607,2443,78.8,1233.0,2000.0
valparaiso,32.0,,758,1702,.445,530,1083,.489,228,619,.368,384,590,.651,399,773,1172,459,236,120,535,556,2128,66.5,1434.0,2000.0
winthrop,30.0,,733,1719,.426,482,1017,.474,251,702,.358,476,717,.664,394,777,1171,406,215,104,474,584,2193,73.1,1457.0,2000.0
dayton,31.0,,752,1735,.433,534,1145,.466,218,590,.369,492,690,.713,447,706,1153,412,215,70,429,559,2214,71.4,1173.0,2000.0
northern-arizona,31.0,,775,1626,.477,512,953,.537,263,673,.391,467,622,.751,295,806,1101,493,120,96,514,574,2280,73.5,1319.0,2000.0
samford,32.0,,825,1649,.500,512,845,.606,313,804,.389,360,515,.699,267,729,996,543,230,102,438,532,2323,72.6,1359.0,2000.0
indiana-state,32.0,,756,1739,.435,595,1286,.463,161,453,.355,463,657,.705,314,744,1058,406,292,104,421,549,2136,66.8,1232.0,2000.0
ball-state,31.0,,834,1840,.453,619,1302,.475,215,538,.400,417,681,.612,398,740,1138,428,258,131,420,530,2300,74.2,1123.0,2000.0
saint-louis,33.0,,729,1696,.430,583,1264,.461,146,432,.338,520,758,.686,394,770,1164,401,254,126,586,665,2124,64.4,1387.0,2000.0
fresno-state,34.0,,1021,2167,.471,742,1373,.540,279,794,.351,478,680,.703,422,887,1309,654,282,161,509,597,2799,82.3,1201.0,2000.0
north-carolina-wilmington,31.0,,667,1609,.415,491,1136,.432,176,473,.372,353,561,.629,323,752,1075,375,221,67,566,566,1863,60.1,1423.0,2000.0
utah-state,34.0,,879,1888,.466,685,1352,.507,194,536,.362,445,709,.628,415,818,1233,487,235,126,453,580,2397,70.5,1429.0,2000.0
lamar,31.0,,672,1725,.390,456,1082,.421,216,643,.336,389,567,.686,381,747,1128,408,225,86,486,530,1949,62.9,1249.0,2000.0
butler,31.0,,753,1599,.471,600,1193,.503,153,406,.377,448,680,.659,322,732,1054,430,237,88,391,513,2107,68.0,1139.0,2000.0
pennsylvania,29.0,,707,1565,.452,518,1027,.504,189,538,.351,339,526,.644,310,746,1056,436,158,119,369,475,1942,67.0,1335.0,2000.0
depaul,33.0,,877,1935,.453,682,1372,.497,195,563,.346,438,655,.669,518,784,1302,494,267,126,538,597,2387,72.3,1177.0,2000.0
arkansas,34.0,,931,2168,.429,639,1336,.478,292,832,.351,375,622,.603,451,708,1159,458,379,120,494,705,2529,74.4,1116.0,2000.0
missouri,31.0,,771,1822,.423,480,1018,.472,291,804,.362,469,661,.710,335,704,1039,426,275,61,412,601,2302,74.3,1281.0,2000.0
appalachian-state,32.0,,915,1882,.486,715,1367,.523,200,515,.388,500,705,.709,374,777,1151,534,325,127,506,627,2530,79.1,1111.0,2000.0
hofstra,31.0,,827,1813,.456,602,1186,.508,225,627,.359,428,623,.687,390,735,1125,435,270,121,415,565,2307,74.4,1220.0,2000.0
indiana,29.0,,811,1697,.478,684,1361,.503,127,336,.378,504,711,.709,329,799,1128,466,217,141,424,524,2253,77.7,1231.0,2000.0
oregon,30.0,,808,1722,.469,636,1170,.544,172,552,.312,481,646,.745,336,701,1037,491,206,88,469,592,2269,75.6,1332.0,2000.0
south-carolina-state,34.0,,829,2117,.392,616,1479,.416,213,638,.334,515,765,.673,590,803,1393,370,237,138,485,485,2386,70.2,1354.0,2000.0
lafayette,31.0,,774,1704,.454,525,1065,.493,249,639,.390,483,672,.719,342,767,1109,473,313,104,499,558,2280,73.5,1248.0,2000.0
louisiana-lafayette,34.0,,880,2047,.430,680,1446,.470,200,601,.333,479,778,.616,508,393,901,496,271,115,,212,2441,71.8,1418.0,2000.0
nevada-las-vegas,31.0,,929,2043,.455,762,1515,.503,167,528,.316,523,768,.681,463,839,1302,623,263,139,549,626,2548,82.2,1424.0,2000.0
northwestern-state,32.0,,768,1856,.414,593,1305,.454,175,551,.318,581,877,.662,410,768,1178,392,308,133,537,765,2292,71.6,1322.0,2001.0
boston-college,32.0,,879,1934,.454,649,1283,.506,230,651,.353,559,788,.709,486,680,1166,464,326,97,423,652,2547,79.6,1130.0,2001.0
cincinnati,35.0,,921,2076,.444,707,1476,.479,214,600,.357,530,760,.697,464,752,1216,451,194,118,380,666,2586,73.9,1153.0,2001.0
duke,39.0,,1217,2530,.481,810,1473,.550,407,1057,.385,697,1002,.696,538,967,1505,701,411,196,531,659,3538,90.7,1181.0,2001.0
georgetown,33.0,,924,2115,.437,738,1554,.475,186,561,.332,540,817,.661,607,874,1481,547,324,198,550,694,2574,78.0,1207.0,2001.0
georgia-state,34.0,,929,2068,.449,653,1288,.507,276,780,.354,567,808,.702,441,730,1171,449,351,129,435,617,2701,79.4,1209.0,2001.0
hampton,32.0,,850,1846,.460,650,1271,.511,200,575,.348,571,835,.684,434,809,1243,449,218,185,489,596,2471,77.2,1214.0,2001.0
iowa,35.0,,815,1895,.430,605,1322,.458,210,573,.366,753,1068,.705,482,869,1351,474,191,83,520,783,2593,74.1,1234.0,2001.0
kent-state,34.0,,823,1917,.429,643,1401,.459,180,516,.349,564,739,.763,403,700,1103,429,233,105,346,671,2390,70.3,1245.0,2001.0
kentucky,34.0,,988,2051,.482,743,1343,.553,245,708,.346,492,751,.655,464,847,1311,539,229,151,513,631,2713,79.8,1246.0,2001.0
maryland,36.0,,1120,2313,.484,915,1773,.516,205,540,.380,622,894,.696,543,935,1478,692,322,213,523,713,3067,85.2,1268.0,2001.0
missouri,33.0,,847,2015,.420,568,1281,.443,279,734,.380,520,742,.701,466,793,1259,418,258,132,497,679,2493,75.5,1281.0,2001.0
saint-josephs,33.0,,905,1879,.482,650,1163,.559,255,716,.356,560,808,.693,368,873,1241,590,204,128,479,652,2625,79.5,1386.0,2001.0
stanford,34.0,,953,1865,.511,701,1278,.549,252,587,.429,671,903,.743,365,879,1244,568,187,108,438,778,2829,83.2,1390.0,2001.0
ucla,32.0,,902,1947,.463,712,1412,.504,190,535,.355,550,829,.663,441,778,1219,464,249,127,515,670,2544,79.5,1417.0,2001.0
southern-california,34.0,,898,1955,.459,690,1358,.508,208,597,.348,616,873,.706,422,828,1250,514,259,151,512,617,2620,77.1,1425.0,2001.0
utah-state,34.0,,852,1755,.485,652,1242,.525,200,513,.390,500,743,.673,370,807,1177,511,220,132,486,581,2404,70.7,1429.0,2001.0
arizona,36.0,,1015,2131,.476,822,1587,.518,193,544,.355,703,940,.748,487,946,1433,585,283,159,546,630,2926,81.3,1112.0,2001.0
butler,32.0,,755,1643,.460,504,1026,.491,251,617,.407,467,652,.716,305,617,922,388,222,89,377,505,2228,69.6,1139.0,2001.0
charlotte,33.0,,873,1998,.437,568,1150,.494,305,848,.360,532,777,.685,411,856,1267,471,231,97,418,663,2583,78.3,1150.0,2001.0
florida,31.0,,849,1764,.481,593,1096,.541,256,668,.383,555,761,.729,319,826,1145,538,271,114,451,589,2509,80.9,1196.0,2001.0
fresno-state,33.0,,954,2030,.470,713,1352,.527,241,678,.355,540,793,.681,389,851,1240,592,330,209,551,626,2689,81.5,1201.0,2001.0
gonzaga,33.0,,915,1793,.510,670,1187,.564,245,606,.404,645,947,.681,369,896,1265,537,191,135,472,619,2720,82.4,1211.0,2001.0
illinois,35.0,,929,2046,.454,682,1368,.499,247,678,.364,620,880,.705,479,921,1400,550,269,146,524,772,2725,77.9,1228.0,2001.0
indiana-state,34.0,,861,1872,.460,648,1278,.507,213,594,.359,544,772,.705,334,735,1069,521,237,100,402,576,2479,72.9,1232.0,2001.0
kansas,33.0,,1002,1996,.502,819,1531,.535,183,465,.394,520,789,.659,443,964,1407,641,217,170,532,648,2707,82.0,1242.0,2001.0
michigan-state,33.0,,957,1957,.489,811,1504,.539,146,453,.322,493,686,.719,514,890,1404,579,210,133,451,611,2553,77.4,1277.0,2001.0
mississippi,35.0,,865,1958,.442,641,1303,.492,224,655,.342,542,829,.654,416,811,1227,500,285,115,500,719,2496,71.3,1279.0,2001.0
north-carolina,33.0,,945,1972,.479,756,1453,.520,189,519,.364,532,794,.670,411,952,1363,576,244,184,518,576,2611,79.1,1314.0,2001.0
notre-dame,30.0,,814,1763,.462,595,1193,.499,219,570,.384,491,714,.688,370,844,1214,527,199,178,434,501,2338,77.9,1323.0,2001.0
penn-state,33.0,,835,1962,.426,557,1205,.462,278,757,.367,587,768,.764,349,720,1069,481,279,117,407,657,2535,76.8,1336.0,2001.0
syracuse,34.0,,885,2029,.436,700,1477,.474,185,552,.335,520,727,.715,442,771,1213,545,325,203,441,681,2475,72.8,1393.0,2001.0
temple,37.0,,926,2168,.427,645,1353,.477,281,815,.345,471,673,.700,494,828,1322,416,270,138,307,585,2604,70.4,1396.0,2001.0
winthrop,31.0,,684,1676,.408,469,1063,.441,215,613,.351,454,661,.687,398,705,1103,351,223,78,441,610,2037,65.7,1457.0,2001.0
southern-utah,31.0,,783,1602,.489,586,1109,.528,197,493,.400,480,673,.713,335,662,997,462,321,87,470,613,2243,72.4,1381.0,2001.0
brigham-young,33.0,,744,1620,.459,559,1135,.493,185,485,.381,651,835,.780,292,760,1052,414,203,108,433,491,2324,70.4,1140.0,2001.0
monmouth,31.0,,756,1664,.454,555,1094,.507,201,570,.353,467,678,.689,300,755,1055,439,280,105,471,517,2180,70.3,1284.0,2001.0
arkansas,31.0,,881,1990,.443,608,1249,.487,273,741,.368,441,639,.690,410,690,1100,476,365,124,451,654,2476,79.9,1116.0,2001.0
wisconsin,29.0,,575,1349,.426,401,872,.460,174,477,.365,399,568,.702,233,636,869,358,172,68,337,520,1723,59.4,1458.0,2001.0
iowa-state,31.0,,823,1735,.474,641,1299,.493,182,436,.417,623,856,.728,375,853,1228,429,190,102,467,636,2451,79.1,1235.0,2001.0
creighton,32.0,,788,1782,.442,539,1088,.495,249,694,.359,500,712,.702,357,727,1084,490,293,114,426,646,2325,72.7,1166.0,2001.0
indiana,34.0,,858,1896,.453,677,1396,.485,181,500,.362,511,804,.636,377,891,1268,513,231,178,496,650,2408,70.8,1231.0,2001.0
holy-cross,30.0,,640,1437,.445,504,1049,.480,136,388,.351,618,940,.657,388,767,1155,385,188,157,512,583,2034,67.8,1221.0,2001.0
george-mason,30.0,,784,1705,.460,642,1266,.507,142,439,.323,417,633,.659,357,661,1018,411,252,129,429,544,2127,70.9,1206.0,2001.0
georgia,31.0,,845,1820,.464,703,1409,.499,142,411,.345,425,632,.672,397,796,1193,471,195,149,485,569,2257,72.8,1208.0,2001.0
georgia-tech,30.0,,776,1822,.426,516,1122,.460,260,700,.371,457,662,.690,345,780,1125,488,238,136,474,645,2269,75.6,1210.0,2001.0
north-carolina-greensboro,31.0,,773,1741,.444,589,1261,.467,184,480,.383,552,718,.769,343,706,1049,414,271,118,475,648,2282,73.6,1422.0,2001.0
hofstra,31.0,,784,1657,.473,617,1154,.535,167,503,.332,522,807,.647,373,793,1166,414,237,119,511,547,2257,72.8,1220.0,2001.0
oklahoma-state,30.0,,767,1652,.464,638,1257,.508,129,395,.327,466,736,.633,364,775,1139,406,241,115,506,568,2129,71.0,1329.0,2001.0
ohio-state,31.0,,775,1645,.471,606,1202,.504,169,443,.381,487,697,.699,355,735,1090,473,161,160,471,607,2206,71.2,1326.0,2001.0
eastern-illinois,31.0,,915,1931,.474,685,1347,.509,230,584,.394,504,650,.775,359,765,1124,514,197,116,427,577,2564,82.7,1183.0,2001.0
wake-forest,30.0,,838,1815,.462,661,1321,.500,177,494,.358,443,609,.727,342,762,1104,465,219,136,375,572,2296,76.5,1448.0,2001.0
tennessee,33.0,,909,1980,.459,652,1283,.508,257,697,.369,593,872,.680,421,880,1301,528,232,191,528,712,2668,80.8,1397.0,2001.0
western-kentucky,31.0,,812,1789,.454,599,1184,.506,213,605,.352,466,674,.691,441,799,1240,452,246,155,453,588,2303,74.3,1443.0,2001.0
california,31.0,,813,1699,.479,637,1196,.533,176,503,.350,502,732,.686,281,717,998,508,225,66,424,570,2304,74.3,1143.0,2001.0
virginia,29.0,,852,1872,.455,648,1319,.491,204,553,.369,556,755,.736,437,694,1131,420,221,98,399,590,2464,85.0,1438.0,2001.0
oklahoma,33.0,,859,1924,.446,617,1288,.479,242,636,.381,494,668,.740,420,764,1184,444,281,91,420,706,2454,74.4,1328.0,2001.0
cal-state-northridge,32.0,,910,1842,.494,693,1295,.535,217,547,.397,613,865,.709,373,785,1158,608,267,77,489,716,2650,82.8,1169.0,2001.0
alabama-state,31.0,,756,1713,.441,591,1207,.490,165,506,.326,458,696,.658,386,789,1175,410,260,93,510,502,2135,68.9,1106.0,2001.0
iona,33.0,,912,1896,.481,753,1481,.508,159,415,.383,566,822,.689,378,861,1239,481,259,183,557,717,2549,77.2,1233.0,2001.0
princeton,27.0,,540,1203,.449,322,584,.551,218,619,.352,264,363,.727,174,518,692,383,180,61,340,456,1562,57.9,1343.0,2001.0
xavier,29.0,,706,1653,.427,528,1066,.495,178,587,.303,540,768,.703,391,642,1033,398,208,115,415,551,2130,73.4,1462.0,2001.0
providence,31.0,6200.0,806,1809,.446,557,1187,.469,249,622,.400,498,693,.719,391,738,1129,506,286,172,467,644,2359,76.1,1344.0,2001.0
hawaii,31.0,,797,1703,.468,620,1196,.518,177,507,.349,483,666,.725,335,664,999,557,183,74,516,605,2254,72.7,1218.0,2001.0
texas,34.0,,819,1990,.412,604,1364,.443,215,626,.343,543,835,.650,483,863,1346,414,268,191,502,771,2396,70.5,1400.0,2001.0
siena,36.0,7400.0,853,2044,.417,603,1322,.456,250,722,.346,561,754,.744,402,959,1361,465,199,149,550,,2517,69.9,1373.0,2002.0
alabama,35.0,,910,2071,.439,693,1368,.507,217,703,.309,621,844,.736,509,860,1369,460,257,113,490,,2658,75.9,1104.0,2002.0
arizona,34.0,,935,2039,.459,677,1353,.500,258,686,.376,665,910,.731,430,856,1286,527,207,103,478,,2793,82.1,1112.0,2002.0
duke,35.0,,1093,2209,.495,792,1379,.574,301,830,.363,625,906,.690,428,875,1303,625,351,113,501,,3112,88.9,1181.0,2002.0
indiana,37.0,,916,1990,.460,646,1331,.485,270,659,.410,505,726,.696,406,897,1303,546,254,192,508,,2607,70.5,1231.0,2002.0
kansas,37.0,,1259,2487,.506,1035,1951,.530,224,536,.418,623,867,.719,557,1081,1638,767,357,210,602,,3365,90.9,1242.0,2002.0
kent-state,36.0,7250.0,986,2102,.469,762,1488,.512,224,614,.365,536,736,.728,474,848,1322,483,229,72,391,,2732,75.9,1245.0,2002.0
kentucky,32.0,,905,2021,.448,686,1329,.516,219,692,.316,431,638,.676,492,791,1283,471,252,153,460,,2460,76.9,1246.0,2002.0
missouri,36.0,,1031,2253,.458,705,1419,.497,326,834,.391,489,709,.690,535,880,1415,539,264,154,511,,2877,79.9,1281.0,2002.0
notre-dame,33.0,,934,2037,.459,690,1393,.495,244,644,.379,489,690,.709,436,915,1351,629,259,163,435,,2601,78.8,1323.0,2002.0
ohio-state,32.0,,825,1702,.485,650,1236,.526,175,466,.376,537,795,.675,351,701,1052,483,193,75,421,,2362,73.8,1326.0,2002.0
oregon,35.0,,1014,2082,.487,710,1361,.522,304,721,.422,662,861,.769,384,896,1280,580,261,114,482,,2994,85.5,1332.0,2002.0
stanford,30.0,6075.0,822,1823,.451,615,1215,.506,207,608,.340,569,813,.700,446,808,1254,480,152,130,409,,2420,80.7,1390.0,2002.0
tulsa,34.0,6825.0,961,2016,.477,702,1377,.510,259,639,.405,545,724,.753,373,841,1214,586,269,153,436,,2726,80.2,1409.0,2002.0
north-carolina-wilmington,33.0,6650.0,784,1803,.435,563,1211,.465,221,592,.373,451,655,.689,374,762,1136,453,274,104,403,,2240,67.9,1423.0,2002.0
wake-forest,34.0,,1001,2094,.478,761,1439,.529,240,655,.366,547,741,.738,438,871,1309,553,220,140,497,,2789,82.0,1448.0,2002.0
wyoming,31.0,,795,1745,.456,663,1305,.508,132,440,.300,602,862,.698,394,851,1245,418,212,136,449,,2324,75.0,1461.0,2002.0
california,32.0,,835,1849,.452,648,1254,.517,187,595,.314,453,669,.677,365,722,1087,487,254,132,423,,2310,72.2,1143.0,2002.0
cincinnati,35.0,,967,2071,.467,758,1494,.507,209,577,.362,595,839,.709,462,934,1396,480,167,154,416,,2738,78.2,1153.0,2002.0
connecticut,34.0,,972,2012,.483,818,1621,.505,154,391,.394,548,787,.696,464,917,1381,494,256,236,545,,2646,77.8,1163.0,2002.0
creighton,32.0,6550.0,849,1829,.464,619,1210,.512,230,619,.372,493,675,.730,384,758,1142,488,261,125,458,,2421,75.7,1166.0,2002.0
georgia,32.0,6450.0,871,1947,.447,682,1359,.502,189,588,.321,513,696,.737,468,758,1226,495,281,114,455,,2444,76.4,1208.0,2002.0
illinois,35.0,,908,1932,.470,654,1240,.527,254,692,.367,638,862,.740,392,872,1264,590,258,141,511,,2708,77.4,1228.0,2002.0
maryland,36.0,7200.0,1083,2248,.482,866,1668,.519,217,580,.374,677,933,.726,473,1006,1479,714,302,216,495,,3060,85.0,1268.0,2002.0
mississippi-state,35.0,,943,1965,.480,751,1414,.531,192,551,.348,504,772,.653,457,902,1359,566,294,123,583,,2582,73.8,1280.0,2002.0
north-carolina-state,34.0,6800.0,863,1910,.452,585,1137,.515,278,773,.360,561,743,.755,354,765,1119,547,269,72,452,,2565,75.4,1301.0,2002.0
oklahoma,36.0,7275.0,1011,2281,.443,775,1607,.482,236,674,.350,549,716,.767,543,896,1439,517,325,134,427,,2807,78.0,1328.0,2002.0
pittsburgh,35.0,,928,1974,.470,708,1292,.548,220,682,.323,454,751,.605,464,881,1345,590,235,156,498,,2530,72.3,1338.0,2002.0
southern-illinois,36.0,,976,2115,.461,756,1514,.499,220,601,.366,545,880,.619,483,913,1396,547,262,171,493,,2717,75.5,1356.0,2002.0
texas,34.0,6900.0,949,2096,.453,749,1552,.483,200,544,.368,559,814,.687,524,832,1356,516,211,131,466,,2657,78.1,1400.0,2002.0
ucla,33.0,6650.0,902,1912,.472,679,1340,.507,223,572,.390,449,649,.692,393,816,1209,475,182,93,496,,2476,75.0,1417.0,2002.0
wisconsin,32.0,,731,1675,.436,520,1082,.481,211,593,.356,471,655,.719,328,704,1032,407,188,60,414,,2144,67.0,1458.0,2002.0
xavier,32.0,6425.0,777,1732,.449,580,1180,.492,197,552,.357,566,785,.721,389,799,1188,400,215,143,435,,2317,72.4,1462.0,2002.0
alcorn-state,31.0,,900,1935,.465,727,1477,.492,173,458,.378,500,777,.644,453,790,1243,496,258,125,538,,2473,79.8,1108.0,2002.0
florida-atlantic,31.0,,859,2011,.427,681,1484,.459,178,527,.338,407,611,.666,505,707,1212,483,294,108,474,,2303,74.3,1194.0,2002.0
california-santa-barbara,31.0,,693,1544,.449,492,1045,.471,201,499,.403,479,634,.756,301,777,1078,454,171,87,423,,2066,66.6,1364.0,2002.0
winthrop,31.0,6250.0,725,1735,.418,531,1105,.481,194,630,.308,448,684,.655,405,773,1178,359,236,129,459,,2092,67.5,1457.0,2002.0
utah,30.0,,688,1467,.469,452,885,.511,236,582,.405,406,603,.673,263,654,917,439,180,82,397,,2018,67.3,1428.0,2002.0
holy-cross,33.0,6625.0,694,1711,.406,546,1272,.429,148,439,.337,547,791,.692,420,756,1176,438,258,103,470,,2083,63.1,1221.0,2002.0
oklahoma-state,32.0,,835,1863,.448,668,1353,.494,167,510,.327,456,708,.644,481,798,1279,460,247,110,486,,2293,71.7,1329.0,2002.0
valparaiso,33.0,6625.0,893,1989,.449,618,1204,.513,275,785,.350,503,754,.667,448,794,1242,570,334,136,437,,2564,77.7,1434.0,2002.0
miami-fl,32.0,6500.0,818,1902,.430,582,1218,.478,236,684,.345,523,678,.771,388,786,1174,525,285,190,460,,2395,74.8,1274.0,2002.0
charlotte,30.0,6025.0,761,1730,.440,514,1054,.488,247,676,.365,436,616,.708,377,759,1136,416,203,72,408,,2205,73.5,1150.0,2002.0
davidson,31.0,,776,1778,.436,527,1073,.491,249,705,.353,391,574,.681,369,824,1193,484,210,116,486,,2192,70.7,1172.0,2002.0
montana,31.0,6200.0,760,1670,.455,547,1074,.509,213,596,.357,485,721,.673,306,741,1047,452,164,120,464,,2218,71.5,1285.0,2002.0
western-kentucky,32.0,6475.0,876,1884,.465,597,1150,.519,279,734,.380,460,658,.699,410,819,1229,501,228,106,456,,2491,77.8,1443.0,2002.0
marquette,33.0,6600.0,871,1841,.473,698,1385,.504,173,456,.379,498,720,.692,420,750,1170,462,279,113,455,,2413,73.1,1266.0,2002.0
southern-california,32.0,6475.0,909,2063,.441,708,1483,.477,201,580,.347,475,686,.692,455,776,1231,504,287,129,389,,2494,77.9,1425.0,2002.0
pepperdine,31.0,6325.0,906,1990,.455,673,1355,.497,233,635,.367,474,661,.717,410,766,1176,445,229,159,449,,2519,81.3,1337.0,2002.0
gonzaga,33.0,,907,1931,.470,670,1325,.506,237,606,.391,626,855,.732,425,945,1370,522,189,113,458,,2677,81.1,1211.0,2002.0
pennsylvania,32.0,,815,1701,.479,549,1033,.531,266,668,.398,446,609,.732,265,770,1035,561,209,108,421,,2342,73.2,1335.0,2002.0
boston-university,32.0,,748,1767,.423,545,1200,.454,203,567,.358,448,651,.688,393,807,1200,399,192,84,415,,2147,67.1,1131.0,2002.0
hampton,33.0,,933,1940,.481,715,1325,.540,218,615,.354,539,805,.670,457,784,1241,470,265,115,489,,2623,79.5,1214.0,2002.0
florida,31.0,,892,1899,.470,660,1241,.532,232,658,.353,479,687,.697,430,773,1203,519,307,141,463,,2495,80.5,1196.0,2002.0
murray-state,32.0,,941,2093,.450,731,1441,.507,210,652,.322,422,584,.723,510,771,1281,465,258,158,456,,2514,78.6,1293.0,2002.0
san-diego-state,33.0,6675.0,906,1902,.476,759,1493,.508,147,409,.359,496,752,.660,400,819,1219,472,225,123,508,,2455,74.4,1361.0,2002.0
mcneese-state,30.0,6025.0,743,1687,.440,572,1221,.468,171,466,.367,445,681,.653,406,733,1139,387,260,153,480,,2102,70.1,1270.0,2002.0
michigan-state,31.0,6200.0,764,1654,.462,584,1196,.488,180,458,.393,442,573,.771,377,786,1163,438,155,93,461,,2150,69.4,1277.0,2002.0
illinois-chicago,34.0,,862,1953,.441,611,1334,.458,251,619,.405,528,802,.658,423,757,1180,462,195,48,435,,2503,73.6,1227.0,2002.0
central-connecticut-state,32.0,,814,1777,.458,675,1380,.489,139,397,.350,513,697,.736,418,829,1247,426,215,107,480,,2280,71.3,1148.0,2002.0
texas-tech,32.0,,931,1999,.466,785,1611,.487,146,388,.376,524,768,.682,419,811,1230,588,243,134,397,,2532,79.1,1403.0,2002.0
boston-college,32.0,,801,1913,.419,589,1284,.459,212,629,.337,540,776,.696,452,740,1192,431,259,106,449,,2354,73.6,1130.0,2002.0
mississippi,31.0,,745,1618,.460,510,1000,.510,235,618,.380,507,687,.738,334,697,1031,427,226,57,476,,2232,72.0,1279.0,2002.0
st-johns-ny,32.0,6475.0,784,1953,.401,645,1469,.439,139,484,.287,543,811,.670,498,708,1206,368,323,120,484,,2250,70.3,1385.0,2002.0
hawaii,33.0,,818,1818,.450,577,1184,.487,241,634,.380,490,716,.684,338,765,1103,546,230,116,407,,2367,71.7,1218.0,2002.0
north-carolina-asheville,32.0,6550.0,801,1848,.433,589,1262,.467,212,586,.362,506,665,.761,393,749,1142,430,230,99,514,616,2320,72.5,1421.0,2003.0
arizona,32.0,6500.0,973,2111,.461,745,1466,.508,228,645,.353,551,777,.709,479,895,1374,569,274,136,468,559,2725,85.2,1112.0,2003.0
arizona-state,32.0,,886,1838,.482,755,1434,.526,131,404,.324,561,832,.674,434,728,1162,506,173,139,437,626,2464,77.0,1113.0,2003.0
central-michigan,32.0,6400.0,864,1714,.504,640,1140,.561,224,574,.390,601,789,.762,347,732,1079,504,237,120,577,658,2553,79.8,1141.0,2003.0
california,31.0,,847,1819,.466,649,1289,.503,198,530,.374,409,601,.681,350,745,1095,487,203,87,433,533,2301,74.2,1143.0,2003.0
connecticut,33.0,6625.0,964,2057,.469,768,1549,.496,196,508,.386,498,736,.677,486,921,1407,502,192,253,507,604,2622,79.5,1163.0,2003.0
duke,33.0,6650.0,897,1981,.453,653,1309,.499,244,672,.363,639,897,.712,431,775,1206,444,286,178,462,698,2677,81.1,1181.0,2003.0
gonzaga,33.0,6725.0,862,1843,.468,623,1208,.516,239,635,.376,595,822,.724,394,840,1234,520,218,116,474,619,2558,77.5,1211.0,2003.0
illinois,32.0,6400.0,859,1793,.479,626,1157,.541,233,636,.366,437,603,.725,305,828,1133,575,227,100,418,598,2388,74.6,1228.0,2003.0
kansas,38.0,,1182,2393,.494,999,1847,.541,183,546,.335,594,906,.656,550,1039,1589,653,373,192,562,633,3141,82.7,1242.0,2003.0
marquette,33.0,,901,1871,.482,699,1363,.513,202,508,.398,585,759,.771,487,721,1208,533,198,117,438,622,2589,78.5,1266.0,2003.0
missouri,33.0,6625.0,870,1959,.444,618,1260,.490,252,699,.361,397,600,.662,437,864,1301,452,185,144,457,562,2389,72.4,1281.0,2003.0
notre-dame,34.0,6875.0,917,2055,.446,634,1320,.480,283,735,.385,575,756,.761,378,925,1303,558,248,189,446,551,2692,79.2,1323.0,2003.0
oklahoma,34.0,6875.0,853,1912,.446,603,1274,.473,250,638,.392,436,629,.693,414,837,1251,482,237,123,412,619,2392,70.4,1328.0,2003.0
stanford,33.0,6625.0,851,1925,.442,620,1277,.486,231,648,.356,458,676,.678,449,830,1279,482,177,117,470,618,2391,72.5,1390.0,2003.0
tulsa,33.0,,877,1884,.465,660,1293,.510,217,591,.367,452,619,.730,365,856,1221,488,242,159,467,565,2423,73.4,1409.0,2003.0
wisconsin,32.0,,798,1723,.463,597,1160,.515,201,563,.357,453,619,.732,326,719,1045,423,221,88,334,478,2250,70.3,1458.0,2003.0
auburn,34.0,,879,1890,.465,681,1317,.517,198,573,.346,452,685,.660,417,783,1200,457,269,176,541,561,2408,70.8,1120.0,2003.0
butler,33.0,6700.0,786,1655,.475,512,956,.536,274,699,.392,383,533,.719,261,662,923,420,207,59,353,528,2229,67.5,1139.0,2003.0
florida,33.0,6675.0,883,1856,.476,596,1121,.532,287,735,.390,431,613,.703,352,797,1149,542,249,131,438,559,2484,75.3,1196.0,2003.0
indiana,34.0,6875.0,788,1851,.426,534,1124,.475,254,727,.349,546,760,.718,387,847,1234,470,146,175,392,613,2376,69.9,1231.0,2003.0
kentucky,36.0,,1026,2102,.488,818,1517,.539,208,585,.356,522,742,.704,460,864,1324,574,281,176,501,625,2782,77.3,1246.0,2003.0
louisville,32.0,,902,1950,.463,630,1198,.526,272,752,.362,536,770,.696,442,778,1220,529,237,148,426,725,2612,81.6,1257.0,2003.0
maryland,31.0,6250.0,901,1940,.464,697,1417,.492,204,523,.390,466,654,.713,409,832,1241,573,322,198,431,588,2472,79.7,1268.0,2003.0
michigan-state,35.0,7025.0,812,1795,.452,633,1318,.480,179,477,.375,564,767,.735,373,853,1226,474,217,121,502,707,2367,67.6,1277.0,2003.0
oklahoma-state,32.0,6425.0,800,1784,.448,643,1288,.499,157,496,.317,467,719,.650,397,778,1175,408,286,171,474,644,2224,69.5,1329.0,2003.0
pittsburgh,33.0,,893,1766,.506,685,1194,.574,208,572,.364,479,748,.640,369,834,1203,589,271,134,484,591,2473,74.9,1338.0,2003.0
purdue,30.0,,715,1638,.437,558,1171,.477,157,467,.336,569,757,.752,312,703,1015,360,216,85,413,598,2156,71.9,1345.0,2003.0
syracuse,35.0,7025.0,1020,2146,.475,834,1606,.519,186,540,.344,559,806,.694,478,947,1425,523,298,247,494,592,2785,79.6,1393.0,2003.0
texas,33.0,,916,2055,.446,720,1505,.478,196,550,.356,590,818,.721,531,855,1386,478,206,121,431,675,2618,79.3,1400.0,2003.0
utah,33.0,6650.0,757,1679,.451,521,1059,.492,236,620,.381,441,620,.711,333,760,1093,427,163,124,427,658,2191,66.4,1428.0,2003.0
wake-forest,31.0,6250.0,805,1778,.453,614,1218,.504,191,560,.341,611,813,.752,459,833,1292,441,201,143,475,578,2412,77.8,1448.0,2003.0
xavier,32.0,,850,1897,.448,644,1326,.486,206,571,.361,576,772,.746,460,799,1259,523,172,96,407,500,2482,77.6,1462.0,2003.0
texas-southern,31.0,,771,1721,.448,581,1147,.507,190,574,.331,536,876,.612,411,773,1184,442,198,67,472,571,2268,73.2,1411.0,2003.0
vermont,33.0,6650.0,835,1870,.447,656,1350,.486,179,520,.344,426,640,.666,425,870,1295,477,230,102,479,520,2275,68.9,1436.0,2003.0
memphis,30.0,,787,1809,.435,577,1199,.481,210,610,.344,448,685,.654,448,755,1203,493,216,152,412,563,2232,74.4,1272.0,2003.0
creighton,34.0,6825.0,974,1956,.498,704,1263,.557,270,693,.390,470,678,.693,373,782,1155,575,283,153,461,591,2688,79.1,1166.0,2003.0
north-carolina-state,31.0,6250.0,755,1656,.456,507,960,.528,248,696,.356,488,634,.770,290,699,989,456,238,100,440,580,2246,72.5,1301.0,2003.0
brigham-young,32.0,6425.0,765,1654,.463,571,1137,.502,194,517,.375,575,762,.755,353,781,1134,428,222,82,436,688,2299,71.8,1140.0,2003.0
colorado-state,33.0,6625.0,876,1733,.505,739,1353,.546,137,380,.361,561,805,.697,374,801,1175,514,179,149,553,682,2450,74.2,1161.0,2003.0
cincinnati,29.0,,667,1653,.404,470,1080,.435,197,573,.344,423,613,.690,366,664,1030,357,152,125,307,556,1954,67.4,1153.0,2003.0
western-kentucky,33.0,,860,1866,.461,607,1171,.518,253,695,.364,457,692,.660,411,775,1186,473,234,120,497,608,2430,73.6,1443.0,2003.0
utah-state,33.0,6650.0,799,1727,.463,665,1271,.523,134,456,.294,465,651,.714,414,740,1154,471,168,69,406,528,2197,66.6,1429.0,2003.0
holy-cross,31.0,,759,1643,.462,589,1174,.502,170,469,.362,492,695,.708,377,754,1131,489,246,138,426,577,2180,70.3,1221.0,2003.0
southern-illinois,31.0,6250.0,847,1801,.470,656,1307,.502,191,494,.387,422,603,.700,336,692,1028,430,245,96,388,600,2307,74.4,1356.0,2003.0
milwaukee,32.0,,874,1855,.471,628,1160,.541,246,695,.354,472,681,.693,370,731,1101,542,283,114,475,649,2466,77.1,1454.0,2003.0
south-carolina-state,31.0,,765,1683,.455,604,1199,.504,161,484,.333,547,782,.699,396,749,1145,316,247,89,602,643,2238,72.2,1354.0,2003.0
san-diego,30.0,6050.0,765,1626,.470,555,1072,.518,210,554,.379,525,789,.665,354,793,1147,496,162,101,536,602,2265,75.5,1360.0,2003.0
dayton,30.0,,738,1638,.451,511,1005,.508,227,633,.359,479,671,.714,403,688,1091,452,159,88,397,529,2182,72.7,1173.0,2003.0
weber-state,32.0,,800,1710,.468,611,1134,.539,189,576,.328,596,815,.731,345,733,1078,455,211,24,403,601,2385,74.5,1451.0,2003.0
saint-josephs,30.0,,725,1637,.443,486,979,.496,239,658,.363,422,615,.686,339,721,1060,417,217,166,387,563,2111,70.4,1386.0,2003.0
mississippi-state,31.0,,806,1718,.469,633,1211,.523,173,507,.341,366,543,.674,374,774,1148,445,268,116,479,490,2151,69.4,1280.0,2003.0
sam-houston-state,30.0,,751,1636,.459,557,1094,.509,194,542,.358,489,694,.705,338,773,1111,502,252,174,475,578,2185,72.8,1358.0,2003.0
alabama,29.0,5825.0,695,1653,.420,512,1085,.472,183,568,.322,429,602,.713,389,690,1079,352,187,112,380,527,2002,69.0,1104.0,2003.0
iupui,34.0,6850.0,833,1855,.449,618,1229,.503,215,626,.343,542,774,.700,404,714,1118,457,289,61,547,654,2423,71.3,1237.0,2003.0
austin-peay,31.0,6300.0,758,1648,.460,566,1095,.517,192,553,.347,496,719,.690,339,745,1084,424,225,143,476,567,2204,71.1,1122.0,2003.0
north-carolina-wilmington,31.0,6250.0,801,1747,.459,585,1166,.502,216,581,.372,396,572,.692,309,713,1022,456,283,58,352,572,2214,71.4,1423.0,2003.0
colorado,32.0,,869,1961,.443,710,1474,.482,159,487,.326,508,759,.669,461,890,1351,424,196,214,447,568,2405,75.2,1160.0,2003.0
pennsylvania,28.0,5625.0,668,1432,.466,417,824,.506,251,608,.413,371,523,.709,254,672,926,418,199,59,370,500,1958,69.9,1335.0,2003.0
wagner,32.0,6400.0,865,1841,.470,640,1252,.511,225,589,.382,448,616,.727,381,717,1098,514,239,89,482,566,2403,75.1,1447.0,2003.0
louisiana-state,32.0,6400.0,851,1767,.482,636,1196,.532,215,571,.377,409,633,.646,346,778,1124,515,255,132,446,524,2326,72.7,1261.0,2003.0
manhattan,30.0,6125.0,774,1730,.447,608,1250,.486,166,480,.346,560,711,.788,342,690,1032,418,275,115,423,650,2274,75.8,1264.0,2003.0
oregon,33.0,6625.0,934,2039,.458,643,1286,.500,291,753,.386,530,685,.774,377,813,1190,567,263,91,504,692,2689,81.5,1332.0,2003.0
east-tennessee-state,31.0,,899,1933,.465,732,1459,.502,167,474,.352,578,791,.731,437,764,1201,448,354,156,561,590,2543,82.0,1190.0,2003.0
troy,32.0,6400.0,914,2116,.432,602,1200,.502,312,916,.341,416,606,.686,486,799,1285,495,309,167,435,531,2556,79.9,1407.0,2003.0
florida-am,32.0,,747,1802,.415,476,1020,.467,271,782,.347,546,771,.708,,,1089,405,271,51,537,693,2311,72.2,1197.0,2004.0
alabama,33.0,,813,1802,.451,580,1186,.489,233,616,.378,521,735,.709,366,782,1148,395,213,111,423,598,2380,72.1,1104.0,2004.0
connecticut,39.0,7825.0,1154,2403,.480,905,1784,.507,249,619,.402,516,828,.623,586,1156,1742,681,233,315,532,624,3073,78.8,1163.0,2004.0
depaul,32.0,6500.0,813,1755,.463,650,1305,.498,163,450,.362,468,671,.697,382,777,1159,437,176,74,422,562,2257,70.5,1177.0,2004.0
duke,37.0,7450.0,1018,2161,.471,755,1439,.525,263,722,.364,655,890,.736,474,877,1351,536,340,240,511,699,2954,79.8,1181.0,2004.0
gonzaga,31.0,,899,1765,.509,704,1274,.553,195,491,.397,543,724,.750,348,882,1230,556,192,116,418,500,2536,81.8,1211.0,2004.0
manhattan,31.0,,762,1724,.442,582,1235,.471,180,489,.368,607,798,.761,374,705,1079,338,287,128,395,636,2311,74.5,1264.0,2004.0
maryland,32.0,6500.0,891,2021,.441,726,1531,.474,165,490,.337,530,840,.631,485,837,1322,451,274,215,485,631,2477,77.4,1268.0,2004.0
nevada,34.0,,901,1991,.453,729,1490,.489,172,501,.343,605,830,.729,449,873,1322,478,218,154,445,624,2579,75.9,1305.0,2004.0
north-carolina,30.0,6125.0,877,1912,.459,682,1358,.502,195,554,.352,515,749,.688,460,729,1189,538,287,120,462,556,2464,82.1,1314.0,2004.0
seton-hall,31.0,6250.0,806,1759,.458,625,1238,.505,181,521,.347,435,609,.714,359,775,1134,406,207,95,403,573,2228,71.9,1371.0,2004.0
saint-josephs,32.0,,866,1822,.475,553,1047,.528,313,775,.404,431,614,.702,308,735,1043,520,285,111,370,546,2476,77.4,1386.0,2004.0
stanford,32.0,6400.0,849,1771,.479,680,1307,.520,169,464,.364,489,651,.751,366,812,1178,513,206,140,453,573,2356,73.6,1390.0,2004.0
syracuse,31.0,6225.0,847,1827,.464,706,1397,.505,141,430,.328,430,669,.643,423,757,1180,465,235,205,396,554,2265,73.1,1393.0,2004.0
texas,33.0,6675.0,904,2046,.442,677,1436,.471,227,610,.372,494,726,.680,517,838,1355,447,219,125,388,645,2529,76.6,1400.0,2004.0
texas-tech,34.0,6825.0,922,1985,.464,797,1614,.494,125,371,.337,521,703,.741,385,768,1153,505,278,117,424,562,2490,73.2,1403.0,2004.0
wake-forest,31.0,6300.0,882,1854,.476,646,1243,.520,236,611,.386,590,829,.712,417,731,1148,487,277,95,457,641,2590,83.5,1448.0,2004.0
boston-college,34.0,6900.0,819,1799,.455,691,1406,.491,128,393,.326,546,804,.679,425,799,1224,543,241,102,457,537,2312,68.0,1130.0,2004.0
cincinnati,32.0,6425.0,867,1893,.458,630,1281,.492,237,612,.387,484,723,.669,420,777,1197,517,241,168,393,620,2455,76.7,1153.0,2004.0
georgia-tech,38.0,,1029,2213,.465,762,1484,.513,267,729,.366,586,847,.692,429,993,1422,579,338,172,578,795,2911,76.6,1210.0,2004.0
illinois,33.0,6650.0,887,1899,.467,656,1237,.530,231,662,.349,397,571,.695,381,770,1151,565,224,122,401,618,2402,72.8,1228.0,2004.0
kansas,33.0,6650.0,895,1923,.465,707,1361,.519,188,562,.335,525,743,.707,409,894,1303,572,232,165,485,661,2503,75.8,1242.0,2004.0
kentucky,32.0,,862,1828,.472,658,1256,.524,204,572,.357,437,627,.697,371,789,1160,504,249,110,468,584,2365,73.9,1246.0,2004.0
memphis,30.0,6000.0,736,1751,.420,477,1029,.464,259,722,.359,441,671,.657,402,737,1139,425,218,150,383,543,2172,72.4,1272.0,2004.0
mississippi-state,30.0,6100.0,822,1766,.465,624,1207,.517,198,559,.354,476,717,.664,444,787,1231,416,280,132,458,489,2318,77.3,1280.0,2004.0
north-carolina-state,31.0,6225.0,760,1688,.450,500,935,.535,260,753,.345,481,602,.799,317,729,1046,454,208,69,420,576,2261,72.9,1301.0,2004.0
oklahoma-state,35.0,,1002,1953,.513,836,1512,.553,166,441,.376,528,760,.695,393,860,1253,561,271,128,468,655,2698,77.1,1329.0,2004.0
pacific,33.0,6650.0,764,1633,.468,569,1087,.523,195,546,.357,549,746,.736,304,797,1101,478,194,103,471,561,2272,68.8,1334.0,2004.0
pittsburgh,36.0,7325.0,904,1921,.471,754,1431,.527,150,490,.306,488,748,.652,466,854,1320,523,215,169,455,532,2446,67.9,1338.0,2004.0
alabama-birmingham,32.0,6425.0,882,2006,.440,669,1360,.492,213,646,.330,437,656,.666,401,718,1119,564,371,115,431,681,2414,75.4,1412.0,2004.0
vanderbilt,33.0,6625.0,841,1873,.449,578,1157,.500,263,716,.367,469,660,.711,367,783,1150,541,248,112,419,576,2414,73.2,1435.0,2004.0
wisconsin,32.0,6450.0,754,1687,.447,564,1123,.502,190,564,.337,492,684,.719,347,702,1049,425,220,90,320,493,2190,68.4,1458.0,2004.0
xavier,37.0,7425.0,908,2058,.441,624,1302,.479,284,756,.376,535,777,.689,439,888,1327,494,252,87,459,619,2635,71.2,1462.0,2004.0
lehigh,31.0,6300.0,729,1718,.424,531,1145,.464,198,573,.346,426,595,.716,357,775,1132,412,229,108,450,577,2082,67.2,1250.0,2004.0
southern-illinois,30.0,6000.0,787,1775,.443,602,1227,.491,185,548,.338,372,540,.689,393,664,1057,424,302,91,360,576,2131,71.0,1356.0,2004.0
vermont,31.0,6200.0,734,1739,.422,531,1122,.473,203,617,.329,374,551,.679,360,766,1126,447,218,87,387,475,2045,66.0,1436.0,2004.0
dayton,33.0,6675.0,780,1746,.447,573,1102,.520,207,644,.321,477,717,.665,409,857,1266,489,150,94,467,577,2244,68.0,1173.0,2004.0
alabama-state,31.0,,639,1523,.420,466,1006,.463,173,517,.335,453,691,.656,360,706,1066,315,219,95,537,581,1904,61.4,1106.0,2004.0
valparaiso,31.0,6250.0,765,1740,.440,600,1205,.498,165,535,.308,522,740,.705,368,815,1183,474,210,97,500,692,2217,71.5,1434.0,2004.0
florida,31.0,6250.0,829,1719,.482,580,1058,.548,249,661,.377,462,616,.750,306,775,1081,492,200,98,454,586,2369,76.4,1196.0,2004.0
texas-el-paso,32.0,6400.0,834,1748,.477,637,1235,.516,197,513,.384,614,817,.752,328,778,1106,523,228,86,445,572,2479,77.5,1431.0,2004.0
michigan-state,30.0,6100.0,748,1519,.492,558,1045,.534,190,474,.401,452,586,.771,270,640,910,441,214,54,438,630,2138,71.3,1277.0,2004.0
air-force,29.0,5800.0,585,1216,.481,340,569,.598,245,647,.379,322,453,.711,174,449,623,386,225,68,318,481,1737,59.9,1102.0,2004.0
arizona,30.0,6000.0,942,1938,.486,723,1370,.528,219,568,.386,511,650,.786,421,756,1177,560,206,135,448,483,2614,87.1,1112.0,2004.0
liberty,33.0,,819,1913,.428,613,1243,.493,206,670,.307,440,651,.676,441,794,1235,461,292,104,528,644,2284,69.2,1251.0,2004.0
texas-san-antonio,33.0,,813,1896,.429,579,1248,.464,234,648,.361,540,775,.697,415,827,1242,421,251,99,564,635,2400,72.7,1427.0,2004.0
brigham-young,30.0,6025.0,764,1571,.486,593,1084,.547,171,487,.351,501,692,.724,316,701,1017,445,208,98,409,566,2200,73.3,1140.0,2004.0
princeton,28.0,5700.0,634,1319,.481,465,819,.568,169,500,.338,323,454,.711,241,615,856,376,192,90,372,507,1760,62.9,1343.0,2004.0
charlotte,30.0,6125.0,812,1805,.450,580,1123,.516,232,682,.340,518,798,.649,441,779,1220,484,264,90,458,570,2374,79.1,1150.0,2004.0
virginia-commonwealth,31.0,6250.0,811,1707,.475,603,1177,.512,208,530,.392,372,614,.606,377,782,1159,407,209,120,510,549,2202,71.0,1433.0,2004.0
utah,33.0,,768,1630,.471,572,1124,.509,196,506,.387,402,556,.723,355,785,1140,426,146,111,463,566,2134,64.7,1428.0,2004.0
east-tennessee-state,33.0,6625.0,946,2059,.459,745,1479,.504,201,580,.347,525,762,.689,411,858,1269,505,382,192,514,557,2618,79.3,1190.0,2004.0
northern-iowa,31.0,6275.0,723,1644,.440,500,1014,.493,223,630,.354,478,648,.738,268,800,1068,410,165,63,388,517,2147,69.3,1320.0,2004.0
murray-state,34.0,6850.0,994,2009,.495,770,1350,.570,224,659,.340,518,730,.710,416,845,1261,636,271,146,476,615,2730,80.3,1293.0,2004.0
illinois-chicago,32.0,,810,1797,.451,652,1387,.470,158,410,.385,445,700,.636,423,703,1126,468,247,85,405,572,2223,69.5,1227.0,2004.0
south-carolina,34.0,6875.0,846,1948,.434,620,1257,.493,226,691,.327,465,690,.674,423,801,1224,499,300,178,448,609,2383,70.1,1376.0,2004.0
monmouth,33.0,,752,1802,.417,516,1127,.458,236,675,.350,513,693,.740,303,785,1088,454,252,84,446,579,2253,68.3,1284.0,2004.0
louisiana-lafayette,29.0,5800.0,797,1715,.465,560,1077,.520,237,638,.371,403,585,.689,341,647,988,474,260,62,419,538,2234,77.0,1418.0,2004.0
eastern-washington,30.0,6075.0,747,1574,.475,568,1086,.523,179,488,.367,429,608,.706,279,639,918,480,192,49,453,605,2102,70.1,1186.0,2004.0
providence,29.0,5825.0,717,1592,.450,489,963,.508,228,629,.362,398,553,.720,342,634,976,455,264,143,433,469,2060,71.0,1344.0,2004.0
central-florida,31.0,,792,1732,.457,560,1074,.521,232,658,.353,365,510,.716,382,747,1129,520,279,141,473,574,2181,70.4,1416.0,2004.0
washington,31.0,6250.0,890,1911,.466,689,1342,.513,201,569,.353,562,788,.713,382,721,1103,501,226,91,472,667,2543,82.0,1449.0,2004.0
western-michigan,31.0,,845,1840,.459,628,1255,.500,217,585,.371,527,731,.721,449,728,1177,474,276,83,411,600,2434,78.5,1444.0,2004.0
richmond,33.0,,737,1793,.411,549,1186,.463,188,607,.310,467,648,.721,403,761,1164,406,235,143,432,617,2129,64.5,1350.0,2004.0
louisville,30.0,6075.0,737,1757,.419,496,1044,.475,241,713,.338,480,641,.749,351,775,1126,460,249,151,413,616,2195,73.2,1257.0,2004.0
oakland,32.0,6425.0,811,1804,.450,610,1211,.504,201,593,.339,446,671,.665,384,660,1044,474,228,77,390,561,2269,70.9,1324.0,2005.0
arizona,37.0,7475.0,1077,2255,.478,824,1625,.507,253,630,.402,541,697,.776,493,868,1361,610,296,144,548,596,2948,79.7,1112.0,2005.0
boston-college,30.0,6075.0,768,1685,.456,644,1192,.540,124,493,.252,514,722,.712,424,711,1135,527,217,123,403,453,2174,72.5,1130.0,2005.0
cincinnati,33.0,6650.0,839,1923,.436,618,1289,.479,221,634,.349,606,878,.690,471,884,1355,493,179,225,435,586,2505,75.9,1153.0,2005.0
gonzaga,31.0,6200.0,856,1702,.503,703,1299,.541,153,403,.380,589,797,.739,368,823,1191,486,169,106,416,536,2454,79.2,1211.0,2005.0
illinois,39.0,7850.0,1092,2258,.484,748,1381,.542,344,877,.392,474,651,.728,425,913,1338,727,300,123,428,611,3002,77.0,1228.0,2005.0
kentucky,34.0,6875.0,901,1940,.464,683,1305,.523,218,635,.343,483,728,.663,417,780,1197,509,311,147,445,582,2503,73.6,1246.0,2005.0
nevada,32.0,6425.0,791,1730,.457,704,1408,.500,87,322,.270,556,786,.707,395,875,1270,480,225,167,465,504,2225,69.5,1305.0,2005.0
oklahoma,33.0,6625.0,908,1907,.476,694,1331,.521,214,576,.372,450,652,.690,428,744,1172,511,291,135,449,607,2480,75.2,1328.0,2005.0
pacific,31.0,6250.0,794,1598,.497,593,1072,.553,201,526,.382,469,631,.743,310,794,1104,462,154,96,424,455,2258,72.8,1334.0,2005.0
texas-tech,33.0,6650.0,932,1957,.476,787,1591,.495,145,366,.396,526,696,.756,368,788,1156,553,259,123,424,554,2535,76.8,1403.0,2005.0
alabama-birmingham,33.0,6650.0,900,1996,.451,683,1371,.498,217,625,.347,540,776,.696,390,700,1090,516,382,99,444,646,2557,77.5,1412.0,2005.0
utah,35.0,7000.0,837,1628,.514,682,1155,.590,155,473,.328,550,769,.715,374,820,1194,516,211,94,503,506,2379,68.0,1428.0,2005.0
wake-forest,33.0,6700.0,965,1966,.491,714,1337,.534,251,629,.399,620,906,.684,465,850,1315,531,284,118,484,640,2801,84.9,1448.0,2005.0
washington,35.0,7050.0,1102,2271,.485,845,1601,.528,257,670,.384,565,771,.733,523,782,1305,660,288,87,499,718,3026,86.5,1449.0,2005.0
west-virginia,35.0,7100.0,868,1930,.450,549,1045,.525,319,885,.360,446,601,.742,340,725,1065,578,280,130,412,530,2501,71.5,1452.0,2005.0
milwaukee,32.0,,831,1859,.447,569,1124,.506,262,735,.356,476,677,.703,421,728,1149,450,267,114,435,610,2400,75.0,1454.0,2005.0
bucknell,33.0,6625.0,704,1585,.444,486,994,.489,218,591,.369,471,672,.701,306,738,1044,416,262,96,508,630,2097,63.5,1137.0,2005.0
connecticut,31.0,,862,1872,.460,708,1386,.511,154,486,.317,541,773,.700,478,934,1412,531,189,275,468,492,2419,78.0,1163.0,2005.0
duke,33.0,,853,1915,.445,563,1152,.489,290,763,.380,585,821,.713,432,829,1261,421,287,220,454,612,2581,78.2,1181.0,2005.0
florida,32.0,6450.0,844,1751,.482,600,1125,.533,244,626,.390,506,716,.707,366,820,1186,475,228,146,444,598,2438,76.2,1196.0,2005.0
georgia-tech,32.0,6450.0,849,1877,.452,659,1307,.504,190,570,.333,483,699,.691,400,848,1248,471,265,162,483,648,2371,74.1,1210.0,2005.0
iowa-state,31.0,6275.0,784,1794,.437,671,1407,.477,113,387,.292,431,632,.682,376,724,1100,444,295,120,405,524,2112,68.1,1235.0,2005.0
louisville,38.0,7625.0,1011,2165,.467,650,1259,.516,361,906,.398,683,945,.723,489,986,1475,590,327,148,535,701,3066,80.7,1257.0,2005.0
michigan-state,33.0,6675.0,914,1875,.487,695,1260,.552,219,615,.356,543,699,.777,397,801,1198,565,258,87,451,640,2590,78.5,1277.0,2005.0
mississippi-state,34.0,6800.0,870,1958,.444,671,1368,.490,199,590,.337,527,792,.665,492,897,1389,475,232,114,503,532,2466,72.5,1280.0,2005.0
north-carolina-state,35.0,7000.0,871,1915,.455,577,1120,.515,294,795,.370,523,742,.705,375,746,1121,529,260,156,435,658,2559,73.1,1301.0,2005.0
north-carolina,37.0,7400.0,1128,2260,.499,851,1573,.541,277,687,.403,724,998,.725,502,997,1499,706,362,142,594,662,3257,88.0,1314.0,2005.0
oklahoma-state,33.0,6600.0,911,1833,.497,671,1269,.529,240,564,.426,521,668,.780,372,749,1121,556,242,87,453,599,2583,78.3,1329.0,2005.0
southern-illinois,35.0,7000.0,884,1957,.452,682,1403,.486,202,554,.365,395,528,.748,395,749,1144,472,322,101,449,684,2365,67.6,1356.0,2005.0
vermont,32.0,6425.0,805,1852,.435,536,1101,.487,269,751,.358,420,582,.722,397,811,1208,493,216,55,380,506,2299,71.8,1436.0,2005.0
villanova,32.0,,801,1840,.435,576,1214,.474,225,626,.359,509,692,.736,463,730,1193,385,267,178,409,596,2336,73.0,1437.0,2005.0
wisconsin,34.0,6800.0,788,1789,.440,538,1149,.468,250,640,.391,464,685,.677,342,834,1176,444,179,62,389,513,2290,67.4,1458.0,2005.0
alabama-am,32.0,,762,1899,.401,564,1243,.454,198,656,.302,507,827,.613,423,787,1210,426,338,124,488,619,2229,69.7,1105.0,2005.0
utah-state,32.0,,851,1621,.525,666,1148,.580,185,473,.391,428,619,.691,307,788,1095,549,179,92,396,441,2315,72.3,1429.0,2005.0
pennsylvania,29.0,5850.0,684,1580,.433,492,1017,.484,192,563,.341,422,640,.659,362,722,1084,420,233,93,455,570,1982,68.3,1335.0,2005.0
iowa,33.0,6675.0,841,1831,.459,631,1273,.496,210,558,.376,515,745,.691,371,825,1196,501,247,174,476,618,2407,72.9,1234.0,2005.0
winthrop,33.0,6650.0,767,1724,.445,547,1120,.488,220,604,.364,491,725,.677,371,783,1154,477,269,125,464,616,2245,68.0,1457.0,2005.0
fairleigh-dickinson,33.0,,894,1975,.453,676,1349,.501,218,626,.348,426,640,.666,408,792,1200,498,237,145,466,624,2432,73.7,1192.0,2005.0
eastern-kentucky,31.0,6250.0,845,1773,.477,651,1221,.533,194,552,.351,372,555,.670,360,743,1103,480,232,122,451,599,2256,72.8,1184.0,2005.0
texas,31.0,6250.0,816,1789,.456,573,1162,.493,243,627,.388,509,730,.697,418,810,1228,406,187,134,433,548,2384,76.9,1400.0,2005.0
niagara,30.0,,833,1915,.435,563,1162,.485,270,753,.359,601,791,.760,471,751,1222,473,206,98,387,568,2537,84.6,1310.0,2005.0
pittsburgh,29.0,5850.0,738,1567,.471,563,1105,.510,175,462,.379,446,677,.659,414,689,1103,439,189,120,419,496,2097,72.3,1338.0,2005.0
ucla,29.0,5875.0,748,1654,.452,562,1116,.504,186,538,.346,456,634,.719,343,725,1068,417,169,74,464,532,2138,73.7,1417.0,2005.0
louisiana-state,30.0,6125.0,776,1690,.459,571,1119,.510,205,571,.359,500,685,.730,349,748,1097,442,209,127,405,490,2257,75.2,1261.0,2005.0
texas-el-paso,35.0,,901,1955,.461,693,1384,.501,208,571,.364,606,765,.792,386,811,1197,579,255,104,426,581,2616,74.7,1431.0,2005.0
chattanooga,31.0,6200.0,795,1746,.455,627,1192,.526,168,554,.303,495,729,.679,509,775,1284,450,231,60,535,523,2253,72.7,1151.0,2005.0
montana,31.0,,735,1606,.458,553,1092,.506,182,514,.354,500,739,.677,322,796,1118,424,182,93,528,533,2152,69.4,1285.0,2005.0
creighton,34.0,6850.0,823,1820,.452,530,1113,.476,293,707,.414,482,660,.730,336,727,1063,483,234,111,412,598,2421,71.2,1166.0,2005.0
alabama,32.0,6475.0,819,1694,.483,570,1062,.537,249,632,.394,539,732,.736,334,845,1179,453,164,143,410,471,2426,75.8,1104.0,2005.0
kansas,30.0,6100.0,801,1684,.476,603,1145,.527,198,539,.367,451,649,.695,350,779,1129,495,197,115,433,574,2251,75.0,1242.0,2005.0
central-florida,33.0,6650.0,784,1702,.461,501,943,.531,283,759,.373,453,651,.696,405,769,1174,512,221,143,496,622,2304,69.8,1416.0,2005.0
delaware-state,33.0,,667,1585,.421,454,963,.471,213,622,.342,496,668,.743,334,577,911,351,264,92,461,538,2043,61.9,1175.0,2005.0
ohio,32.0,6450.0,773,1675,.461,591,1120,.528,182,555,.328,560,802,.698,348,702,1050,374,273,86,423,571,2288,71.5,1325.0,2005.0
george-washington,30.0,6025.0,833,1750,.476,671,1303,.515,162,447,.362,480,693,.693,390,708,1098,484,293,128,448,528,2308,76.9,1203.0,2005.0
minnesota,32.0,,771,1707,.452,601,1220,.493,170,487,.349,463,656,.706,373,718,1091,453,292,145,516,512,2175,68.0,1278.0,2005.0
louisiana-lafayette,31.0,,804,1802,.446,604,1201,.503,200,601,.333,431,654,.659,437,655,1092,375,291,85,482,604,2239,72.2,1418.0,2005.0
old-dominion,34.0,6825.0,869,1958,.444,659,1334,.494,210,624,.337,482,690,.699,409,830,1239,552,329,151,416,597,2430,71.5,1330.0,2005.0
stanford,31.0,6225.0,774,1778,.435,650,1415,.459,124,363,.342,501,680,.737,380,732,1112,373,207,86,428,559,2173,70.1,1390.0,2005.0
charlotte,29.0,5900.0,763,1767,.432,531,1137,.467,232,630,.368,499,730,.684,420,699,1119,409,252,92,389,495,2257,77.8,1150.0,2005.0
southeastern-louisiana,33.0,,768,1660,.463,651,1284,.507,117,376,.311,432,668,.647,351,666,1017,388,300,122,460,573,2085,63.2,1368.0,2005.0
saint-marys-ca,34.0,,793,1817,.436,559,1147,.487,234,670,.349,553,763,.725,425,819,1244,380,204,113,534,616,2373,69.8,1388.0,2005.0
syracuse,34.0,6850.0,946,1956,.484,790,1457,.542,156,499,.313,500,750,.667,470,821,1291,525,276,157,465,539,2548,74.9,1393.0,2005.0
new-mexico,33.0,6600.0,855,1733,.493,586,1045,.561,269,688,.391,513,755,.679,327,800,1127,491,252,115,454,558,2492,75.5,1307.0,2005.0
northern-iowa,32.0,6450.0,847,1763,.480,621,1170,.531,226,593,.381,391,560,.698,283,788,1071,491,192,138,373,556,2311,72.2,1320.0,2005.0
monmouth,34.0,,787,1785,.441,570,1141,.500,217,644,.337,400,597,.670,296,818,1114,502,254,123,510,570,2191,64.4,1284.0,2006.0
alabama,31.0,6250.0,758,1662,.456,584,1157,.505,174,505,.345,488,689,.708,389,746,1135,379,195,152,421,433,2178,70.3,1104.0,2006.0
boston-college,36.0,,949,1958,.485,738,1373,.538,211,585,.361,562,833,.675,466,811,1277,639,222,161,472,586,2671,74.2,1130.0,2006.0
duke,36.0,7225.0,979,2011,.487,705,1302,.541,274,709,.386,689,905,.761,350,854,1204,546,337,202,496,621,2921,81.1,1181.0,2006.0
florida,39.0,7825.0,1061,2120,.500,772,1382,.559,289,738,.392,641,862,.744,421,981,1402,650,297,207,561,623,3052,78.3,1196.0,2006.0
george-washington,30.0,,845,1814,.466,663,1303,.509,182,511,.356,488,755,.646,421,722,1143,511,278,135,420,553,2360,78.7,1203.0,2006.0
gonzaga,33.0,,897,1879,.477,715,1379,.518,182,500,.364,667,853,.782,411,828,1239,459,234,94,434,625,2643,80.1,1211.0,2006.0
illinois,33.0,6600.0,848,1853,.458,607,1185,.512,241,668,.361,374,582,.643,403,776,1179,500,203,79,406,584,2311,70.0,1228.0,2006.0
indiana,31.0,6200.0,797,1730,.461,521,1031,.505,276,699,.395,361,523,.690,319,734,1053,466,196,72,446,574,2231,72.0,1231.0,2006.0
louisiana-state,36.0,7250.0,972,2092,.465,825,1638,.504,147,454,.324,542,786,.690,496,951,1447,547,298,236,555,567,2633,73.1,1261.0,2006.0
montana,31.0,6275.0,876,1781,.492,648,1191,.544,228,590,.386,469,653,.718,348,748,1096,565,229,95,431,563,2449,79.0,1285.0,2006.0
tennessee,30.0,6000.0,859,1852,.464,595,1169,.509,264,683,.387,431,615,.701,352,653,1005,509,301,98,386,542,2413,80.4,1397.0,2006.0
texas-am,31.0,,725,1627,.446,522,1064,.491,203,563,.361,477,702,.679,325,668,993,509,266,94,416,668,2130,68.7,1401.0,2006.0
ucla,39.0,7825.0,939,1987,.473,703,1305,.539,236,682,.346,528,764,.691,429,874,1303,541,224,111,562,649,2642,67.7,1417.0,2006.0
washington,33.0,6700.0,982,2087,.471,762,1485,.513,220,602,.365,522,697,.749,475,757,1232,529,273,114,486,634,2706,82.0,1449.0,2006.0
milwaukee,31.0,6250.0,797,1832,.435,593,1223,.485,204,609,.335,496,719,.690,452,733,1185,389,216,91,421,595,2294,74.0,1454.0,2006.0
wichita-state,35.0,7100.0,839,1903,.441,602,1255,.480,237,648,.366,507,700,.724,425,892,1317,522,183,64,449,547,2422,69.2,1455.0,2006.0
arizona,33.0,6725.0,909,2037,.446,767,1592,.482,142,445,.319,473,667,.709,453,687,1140,492,322,125,437,549,2433,73.7,1112.0,2006.0
bradley,33.0,,848,1933,.439,663,1382,.480,185,551,.336,478,666,.718,419,822,1241,533,294,151,497,614,2359,71.5,1133.0,2006.0
bucknell,32.0,6450.0,726,1560,.465,530,1057,.501,196,503,.390,466,670,.696,308,724,1032,457,279,55,474,561,2114,66.1,1137.0,2006.0
connecticut,34.0,6900.0,988,2088,.473,800,1574,.508,188,514,.366,617,874,.706,533,955,1488,541,225,298,489,531,2781,81.8,1163.0,2006.0
george-mason,35.0,,897,1863,.481,691,1284,.538,206,579,.356,429,646,.664,352,869,1221,507,249,123,449,529,2429,69.4,1206.0,2006.0
georgetown,33.0,6650.0,787,1682,.468,564,1054,.535,223,628,.355,380,538,.706,354,725,1079,514,199,119,381,486,2177,66.0,1207.0,2006.0
kentucky,35.0,7000.0,903,2020,.447,638,1262,.506,265,758,.350,406,601,.676,449,816,1265,495,206,106,464,595,2477,70.8,1246.0,2006.0
memphis,37.0,,1034,2291,.451,757,1508,.502,277,783,.354,616,903,.682,568,960,1528,566,361,235,575,757,2961,80.0,1272.0,2006.0
north-carolina-state,32.0,6550.0,793,1704,.465,505,927,.545,288,777,.371,509,678,.751,284,766,1050,500,233,150,434,565,2383,74.5,1301.0,2006.0
north-carolina,31.0,6200.0,863,1809,.477,648,1236,.524,215,573,.375,519,733,.708,432,805,1237,552,242,127,512,531,2460,79.4,1314.0,2006.0
northwestern-state,34.0,,914,1981,.461,688,1365,.504,226,616,.367,519,779,.666,458,766,1224,589,312,113,535,698,2573,75.7,1322.0,2006.0
ohio-state,32.0,6475.0,833,1791,.465,571,1073,.532,262,718,.365,435,606,.718,321,767,1088,491,216,89,379,489,2363,73.8,1326.0,2006.0
pittsburgh,33.0,6650.0,840,1842,.456,634,1257,.504,206,585,.352,505,729,.693,422,859,1281,541,203,128,452,565,2391,72.5,1338.0,2006.0
texas,37.0,7425.0,983,2132,.461,714,1410,.506,269,722,.373,546,751,.727,518,980,1498,549,296,186,498,561,2781,75.2,1400.0,2006.0
villanova,33.0,6650.0,809,1942,.417,521,1173,.444,288,769,.375,543,717,.757,459,739,1198,403,256,159,370,615,2449,74.2,1437.0,2006.0
west-virginia,33.0,6625.0,835,1875,.445,498,908,.548,337,967,.349,327,439,.745,258,657,915,576,266,93,287,419,2334,70.7,1452.0,2006.0
hampton,32.0,6400.0,762,1840,.414,585,1279,.457,177,561,.316,419,677,.619,442,816,1258,390,241,99,516,658,2120,66.3,1214.0,2006.0
marquette,31.0,6250.0,830,1823,.455,567,1160,.489,263,663,.397,402,549,.732,377,735,1112,482,233,94,458,597,2325,75.0,1266.0,2006.0
pacific,32.0,,858,1763,.487,643,1210,.531,215,553,.389,446,598,.746,320,815,1135,514,188,67,419,501,2377,74.3,1334.0,2006.0
southern,33.0,,787,1796,.438,644,1348,.478,143,448,.319,376,581,.647,422,812,1234,391,249,122,561,574,2093,63.4,1380.0,2006.0
south-alabama,31.0,6225.0,797,1760,.453,530,1032,.514,267,728,.367,422,600,.703,346,703,1049,436,264,43,415,578,2283,73.6,1375.0,2006.0
north-carolina-wilmington,33.0,,807,1867,.432,591,1228,.481,216,639,.338,420,601,.699,389,802,1191,506,248,55,414,682,2250,68.2,1423.0,2006.0
xavier,32.0,6425.0,778,1685,.462,560,1097,.510,218,588,.371,516,713,.724,338,783,1121,502,199,152,410,568,2290,71.6,1462.0,2006.0
air-force,31.0,6200.0,683,1413,.483,407,729,.558,276,684,.404,348,467,.745,204,559,763,445,249,67,335,472,1990,64.2,1102.0,2006.0
san-diego-state,33.0,6650.0,839,1823,.460,619,1267,.489,220,556,.396,558,767,.728,430,746,1176,432,251,101,498,545,2456,74.4,1361.0,2006.0
iona,31.0,6225.0,881,1835,.480,685,1347,.509,196,488,.402,517,748,.691,413,727,1140,481,239,128,468,576,2475,79.8,1233.0,2006.0
nevada,33.0,6650.0,866,1901,.456,687,1404,.489,179,497,.360,490,682,.718,420,848,1268,514,179,160,426,537,2401,72.8,1305.0,2006.0
winthrop,31.0,,778,1735,.448,540,1077,.501,238,658,.362,482,697,.692,402,725,1127,490,298,102,439,530,2276,73.4,1457.0,2006.0
syracuse,35.0,7075.0,913,2083,.438,653,1317,.496,260,766,.339,449,698,.643,476,862,1338,541,313,221,532,625,2535,72.4,1393.0,2006.0
belmont,31.0,6300.0,897,1819,.493,636,1127,.564,261,692,.377,444,643,.691,364,735,1099,518,240,110,503,612,2499,80.6,1125.0,2006.0
utah-state,32.0,6500.0,853,1714,.498,621,1135,.547,232,579,.401,369,511,.722,304,776,1080,552,165,91,421,492,2307,72.1,1429.0,2006.0
oklahoma,29.0,5800.0,716,1586,.451,542,1101,.492,174,485,.359,389,545,.714,420,640,1060,423,207,100,411,499,1995,68.8,1328.0,2006.0
seton-hall,30.0,6050.0,692,1690,.409,518,1170,.443,174,520,.335,475,637,.746,375,730,1105,373,206,81,403,569,2033,67.8,1371.0,2006.0
wisconsin,31.0,6250.0,776,1796,.432,577,1223,.472,199,573,.347,454,684,.664,400,724,1124,421,165,104,359,534,2205,71.1,1458.0,2006.0
kansas,33.0,6625.0,912,1923,.474,707,1384,.511,205,539,.380,451,671,.672,433,872,1305,589,323,185,516,599,2480,75.2,1242.0,2006.0
arkansas,32.0,6450.0,841,1837,.458,662,1304,.508,179,533,.336,498,720,.692,390,728,1118,495,266,194,428,541,2359,73.7,1116.0,2006.0
albany-ny,32.0,6475.0,743,1660,.448,520,1071,.486,223,589,.379,485,682,.711,349,728,1077,403,209,81,451,606,2194,68.6,1107.0,2006.0
michigan-state,34.0,6950.0,896,1879,.477,692,1339,.517,204,540,.378,524,681,.769,373,839,1212,567,214,101,478,627,2520,74.1,1277.0,2006.0
northern-iowa,33.0,6775.0,754,1662,.454,535,1020,.525,219,642,.341,438,608,.720,279,821,1100,439,179,124,401,480,2165,65.6,1320.0,2006.0
alabama-birmingham,31.0,6200.0,822,1816,.453,600,1169,.513,222,647,.343,440,680,.647,337,634,971,482,337,111,395,560,2306,74.4,1412.0,2006.0
oral-roberts,33.0,,866,1883,.460,648,1323,.490,218,560,.389,522,736,.709,435,780,1215,528,220,140,472,583,2472,74.9,1331.0,2006.0
california,31.0,6325.0,717,1598,.449,548,1146,.478,169,452,.374,525,716,.733,301,701,1002,402,162,83,384,518,2128,68.6,1143.0,2006.0
murray-state,31.0,6275.0,808,1795,.450,578,1143,.506,230,652,.353,357,548,.651,410,731,1141,485,250,147,387,568,2203,71.1,1293.0,2006.0
iowa,34.0,6900.0,781,1811,.431,590,1241,.475,191,570,.335,501,706,.710,372,913,1285,502,225,167,506,517,2254,66.3,1234.0,2006.0
davidson,31.0,,855,1885,.454,578,1134,.510,277,751,.369,416,547,.761,393,822,1215,567,151,51,399,570,2403,77.5,1172.0,2006.0
kent-state,34.0,6875.0,844,1887,.447,607,1227,.495,237,660,.359,533,745,.715,377,753,1130,452,265,82,451,682,2458,72.3,1245.0,2006.0
pennsylvania,29.0,5875.0,710,1595,.445,514,988,.520,196,607,.323,371,550,.675,302,617,919,413,283,78,382,532,1987,68.5,1335.0,2006.0
southern-illinois,33.0,,707,1714,.412,524,1166,.449,183,548,.334,397,579,.686,384,689,1073,404,278,105,473,653,1994,60.4,1356.0,2006.0
niagara,35.0,7075.0,889,2125,.418,615,1326,.464,274,799,.343,602,824,.731,517,825,1342,467,224,55,473,611,2654,75.8,1310.0,2007.0
boston-college,33.0,6650.0,842,1763,.478,646,1201,.538,196,562,.349,573,791,.724,394,748,1142,483,188,191,455,505,2453,74.3,1130.0,2007.0
butler,36.0,7325.0,780,1792,.435,459,921,.498,321,871,.369,553,728,.760,326,742,1068,437,195,64,341,688,2434,67.6,1139.0,2007.0
georgetown,37.0,7425.0,923,1826,.505,688,1191,.578,235,635,.370,474,667,.711,409,841,1250,545,192,189,497,609,2555,69.1,1207.0,2007.0
indiana,32.0,,783,1755,.446,531,1094,.485,252,661,.381,428,603,.710,375,707,1082,424,206,140,396,657,2246,70.2,1231.0,2007.0
louisville,34.0,,845,1946,.434,595,1195,.498,250,751,.333,493,727,.678,456,793,1249,495,251,144,434,698,2433,71.6,1257.0,2007.0
maryland,34.0,6825.0,971,2032,.478,775,1523,.509,196,509,.385,547,787,.695,437,888,1325,587,253,233,544,612,2685,79.0,1268.0,2007.0
michigan-state,35.0,,806,1718,.469,624,1232,.506,182,486,.374,482,671,.718,394,823,1217,560,180,162,521,652,2276,65.0,1277.0,2007.0
north-carolina,38.0,,1187,2379,.499,972,1779,.546,215,600,.358,669,940,.712,522,1029,1551,696,309,173,524,647,3258,85.7,1314.0,2007.0
ohio-state,39.0,,1029,2178,.472,742,1384,.536,287,794,.361,560,797,.703,433,957,1390,583,265,218,443,534,2905,74.5,1326.0,2007.0
pittsburgh,37.0,,961,2035,.472,732,1436,.510,229,599,.382,486,735,.661,445,875,1320,647,194,133,441,613,2637,71.3,1338.0,2007.0
texas-am,34.0,6850.0,908,1823,.498,693,1313,.528,215,510,.422,539,753,.716,345,864,1209,591,224,111,415,663,2570,75.6,1401.0,2007.0
ucla,36.0,,923,1922,.480,683,1284,.532,240,638,.376,417,630,.662,386,772,1158,507,263,116,440,569,2503,69.5,1417.0,2007.0
virginia-commonwealth,35.0,,901,1971,.457,657,1362,.482,244,609,.401,580,797,.728,427,738,1165,475,268,106,394,643,2626,75.0,1433.0,2007.0
vanderbilt,34.0,,904,1984,.456,587,1141,.514,317,843,.376,469,643,.729,346,800,1146,578,257,93,422,584,2594,76.3,1435.0,2007.0
washington-state,34.0,,826,1777,.465,630,1250,.504,196,527,.372,425,593,.717,271,772,1043,472,226,155,355,549,2273,66.9,1450.0,2007.0
xavier,34.0,6825.0,849,1784,.476,580,1095,.530,269,689,.390,628,847,.741,367,779,1146,508,191,120,430,604,2595,76.3,1462.0,2007.0
florida,40.0,,1125,2138,.526,828,1411,.587,297,727,.409,646,936,.690,447,1057,1504,614,266,194,565,626,3193,79.8,1196.0,2007.0
kansas,38.0,7675.0,1106,2241,.494,875,1657,.528,231,584,.396,535,811,.660,486,1021,1507,651,350,246,539,718,2978,78.4,1242.0,2007.0
kentucky,34.0,,890,1868,.476,659,1218,.541,231,650,.355,485,690,.703,370,865,1235,537,201,161,493,547,2496,73.4,1246.0,2007.0
memphis,37.0,7425.0,1024,2249,.455,746,1457,.512,278,792,.351,592,953,.621,550,918,1468,537,344,217,493,732,2918,78.9,1272.0,2007.0
nevada,34.0,6875.0,949,1961,.484,696,1338,.520,253,623,.406,481,636,.756,399,901,1300,569,183,148,451,571,2632,77.4,1305.0,2007.0
oregon,37.0,7450.0,963,2131,.452,613,1234,.497,350,897,.390,531,698,.761,432,841,1273,513,254,74,461,606,2807,75.9,1332.0,2007.0
purdue,34.0,6800.0,843,1834,.460,624,1220,.511,219,614,.357,471,695,.678,388,733,1121,465,269,89,475,674,2376,69.9,1345.0,2007.0
southern-illinois,36.0,,762,1702,.448,538,1090,.494,224,612,.366,518,748,.693,346,730,1076,414,237,116,504,728,2266,62.9,1356.0,2007.0
tennessee,35.0,7075.0,981,2189,.448,654,1293,.506,327,896,.365,542,830,.653,473,781,1254,546,336,108,496,704,2831,80.9,1397.0,2007.0
texas,35.0,7200.0,963,2164,.445,655,1372,.477,308,792,.389,626,850,.736,482,909,1391,479,262,197,434,611,2860,81.7,1400.0,2007.0
nevada-las-vegas,37.0,,979,2202,.445,690,1400,.493,289,802,.360,525,733,.716,460,833,1293,548,289,197,410,670,2772,74.9,1424.0,2007.0
southern-california,37.0,,946,1988,.476,739,1465,.504,207,523,.396,557,779,.715,349,928,1277,472,206,148,540,660,2656,71.8,1425.0,2007.0
virginia,32.0,6425.0,812,1860,.437,555,1154,.481,257,706,.364,582,784,.742,422,826,1248,412,149,103,437,644,2463,77.0,1438.0,2007.0
virginia-tech,34.0,6875.0,886,1894,.468,723,1445,.500,163,449,.363,493,747,.660,366,765,1131,449,285,159,371,619,2428,71.4,1439.0,2007.0
winthrop,34.0,6825.0,923,1935,.477,645,1162,.555,278,773,.360,421,675,.624,422,857,1279,567,268,126,445,584,2545,74.9,1457.0,2007.0
wisconsin,36.0,7225.0,867,1886,.460,657,1289,.510,210,597,.352,583,848,.688,404,854,1258,494,207,116,407,551,2527,70.2,1458.0,2007.0
florida-am,35.0,,846,1881,.450,637,1300,.490,209,581,.360,566,855,.662,,,1291,477,245,63,623,648,2467,70.5,1197.0,2007.0
texas-tech,34.0,6850.0,842,1858,.453,634,1353,.469,208,505,.412,545,737,.739,321,721,1042,452,231,62,396,592,2437,71.7,1403.0,2007.0
old-dominion,33.0,,788,1828,.431,553,1150,.481,235,678,.347,479,663,.722,400,808,1208,483,252,114,406,620,2290,69.4,1330.0,2007.0
belmont,33.0,6650.0,848,1836,.462,560,1025,.546,288,811,.355,406,587,.692,373,855,1228,513,201,105,528,605,2390,72.4,1125.0,2007.0
gonzaga,34.0,6900.0,933,1932,.483,703,1349,.521,230,583,.395,572,762,.751,353,918,1271,492,212,123,473,654,2668,78.5,1211.0,2007.0
stanford,31.0,6325.0,778,1738,.448,604,1239,.487,174,499,.349,426,625,.682,395,798,1193,460,144,184,459,571,2156,69.5,1390.0,2007.0
davidson,34.0,,969,2157,.449,641,1269,.505,328,888,.369,499,663,.753,465,913,1378,559,272,91,495,602,2765,81.3,1172.0,2007.0
marquette,34.0,,851,1951,.436,634,1300,.488,217,651,.333,524,783,.669,488,763,1251,475,295,115,496,691,2443,71.9,1266.0,2007.0
eastern-kentucky,33.0,,782,1691,.462,518,933,.555,264,758,.348,323,475,.680,280,650,930,477,263,84,446,449,2151,65.2,1184.0,2007.0
central-connecticut-state,34.0,6825.0,790,1822,.434,528,1134,.466,262,688,.381,502,688,.730,401,779,1180,424,204,115,481,544,2344,68.9,1148.0,2007.0
wright-state,33.0,6675.0,766,1750,.438,586,1231,.476,180,519,.347,413,564,.732,334,726,1060,402,196,50,400,574,2125,64.4,1460.0,2007.0
pennsylvania,31.0,,836,1712,.488,648,1192,.544,188,520,.362,437,658,.664,324,700,1024,539,263,92,433,573,2297,74.1,1335.0,2007.0
weber-state,32.0,,772,1579,.489,592,1123,.527,180,456,.395,542,807,.672,307,743,1050,437,212,78,515,611,2266,70.8,1451.0,2007.0
duke,33.0,6675.0,822,1754,.469,624,1234,.506,198,520,.381,481,698,.689,379,786,1165,433,241,157,509,577,2323,70.4,1181.0,2007.0
george-washington,32.0,6400.0,824,1799,.458,653,1334,.490,171,465,.368,428,611,.700,389,701,1090,462,292,142,444,603,2247,70.2,1203.0,2007.0
oral-roberts,34.0,6850.0,824,1767,.466,620,1202,.516,204,565,.361,588,827,.711,372,832,1204,459,212,154,513,601,2440,71.8,1331.0,2007.0
brigham-young,34.0,,972,1981,.491,716,1364,.525,256,617,.415,454,688,.660,414,859,1273,542,205,118,456,662,2654,78.1,1140.0,2007.0
jackson-state,35.0,,878,2107,.417,684,1487,.460,194,620,.313,540,759,.711,470,780,1250,469,289,107,537,724,2490,71.1,1238.0,2007.0
villanova,33.0,6600.0,775,1827,.424,527,1123,.469,248,704,.352,594,761,.781,438,758,1196,419,267,107,450,645,2392,72.5,1437.0,2007.0
north-texas,34.0,6925.0,926,2030,.456,700,1420,.493,226,610,.370,539,821,.657,484,872,1356,430,224,151,537,689,2617,77.0,1317.0,2007.0
creighton,33.0,,740,1662,.445,535,1055,.507,205,607,.338,535,710,.754,340,740,1080,441,210,83,417,552,2220,67.3,1166.0,2007.0
miami-oh,33.0,,720,1565,.460,551,1057,.521,169,508,.333,353,498,.709,260,738,998,421,187,135,434,560,1962,59.5,1275.0,2007.0
arizona,31.0,6250.0,846,1770,.478,674,1265,.533,172,505,.341,553,737,.750,380,778,1158,511,189,103,427,425,2417,78.0,1112.0,2007.0
holy-cross,34.0,,738,1695,.435,547,1151,.475,191,544,.351,504,687,.734,386,705,1091,463,324,123,521,621,2171,63.9,1221.0,2007.0
long-beach-state,32.0,6400.0,906,1994,.454,633,1266,.500,273,728,.375,490,698,.702,410,761,1171,454,237,91,445,560,2575,80.5,1253.0,2007.0
new-mexico-state,34.0,6825.0,906,1890,.479,707,1377,.513,199,513,.388,641,975,.657,459,826,1285,472,242,94,573,698,2652,78.0,1308.0,2007.0
georgia-tech,32.0,,935,1909,.490,734,1369,.536,201,540,.372,444,652,.681,445,721,1166,491,316,114,503,665,2515,78.6,1210.0,2007.0
arkansas,35.0,7025.0,881,1910,.461,669,1297,.516,212,613,.346,513,730,.703,392,841,1233,521,240,221,532,612,2487,71.1,1116.0,2007.0
albany-ny,33.0,6650.0,798,1762,.453,571,1155,.494,227,607,.374,418,579,.722,364,748,1112,436,191,82,437,634,2241,67.9,1107.0,2007.0
illinois,35.0,,790,1830,.432,549,1139,.482,241,691,.349,424,680,.624,437,794,1231,488,205,99,491,604,2245,64.1,1228.0,2007.0
notre-dame,32.0,,869,1893,.459,582,1158,.503,287,735,.390,567,763,.743,405,824,1229,552,271,110,414,582,2592,81.0,1323.0,2007.0
texas-am-corpus-christi,33.0,,912,1747,.522,720,1269,.567,192,478,.402,599,847,.707,374,799,1173,595,257,95,537,631,2615,79.2,1394.0,2007.0
mount-st-marys,34.0,6825.0,822,1856,.443,618,1291,.479,204,565,.361,505,718,.703,345,807,1152,437,246,121,486,671,2353,69.2,1291.0,2008.0
duke,34.0,6825.0,964,2084,.463,656,1268,.517,308,816,.377,594,852,.697,426,829,1255,497,295,133,462,654,2830,83.2,1181.0,2008.0
kansas,40.0,,1176,2314,.508,905,1631,.555,271,683,.397,598,852,.702,482,1065,1547,721,356,235,529,706,3221,80.5,1242.0,2008.0
kansas-state,33.0,6650.0,916,2067,.443,706,1405,.502,210,662,.317,532,774,.687,539,823,1362,511,249,113,501,666,2574,78.0,1243.0,2008.0
marquette,35.0,7050.0,929,2082,.446,683,1385,.493,246,697,.353,554,785,.706,474,813,1287,515,325,132,451,733,2658,75.9,1266.0,2008.0
michigan-state,36.0,7200.0,949,1976,.480,770,1493,.516,179,483,.371,487,661,.737,440,890,1330,631,208,152,490,665,2564,71.2,1277.0,2008.0
notre-dame,33.0,6625.0,914,2015,.454,640,1338,.478,274,677,.405,506,686,.738,436,935,1371,608,205,125,429,497,2608,79.0,1323.0,2008.0
pittsburgh,37.0,7450.0,997,2185,.456,772,1514,.510,225,671,.335,512,768,.667,533,866,1399,578,251,125,445,598,2731,73.8,1338.0,2008.0
purdue,34.0,,806,1900,.424,553,1221,.453,253,679,.373,502,705,.712,389,735,1124,451,286,147,436,671,2367,69.6,1345.0,2008.0
stanford,36.0,7300.0,901,2008,.449,702,1464,.480,199,544,.366,552,795,.694,478,931,1409,525,158,187,442,613,2553,70.9,1390.0,2008.0
texas-am,36.0,,909,1945,.467,698,1357,.514,211,588,.359,519,820,.633,424,978,1402,486,158,145,458,611,2548,70.8,1401.0,2008.0
ucla,39.0,7825.0,1029,2164,.476,815,1552,.525,214,612,.350,595,813,.732,492,940,1432,562,285,167,491,569,2867,73.5,1417.0,2008.0
nevada-las-vegas,35.0,,844,1999,.422,580,1203,.482,264,796,.332,488,653,.747,356,853,1209,510,278,106,379,605,2440,69.7,1424.0,2008.0
washington-state,35.0,,815,1716,.475,601,1135,.530,214,581,.368,481,661,.728,274,770,1044,482,218,102,358,534,2325,66.4,1450.0,2008.0
west-virginia,37.0,7500.0,983,2169,.453,719,1426,.504,264,743,.355,539,782,.689,453,879,1332,571,257,188,413,710,2769,74.8,1452.0,2008.0
wisconsin,36.0,7200.0,841,1872,.449,629,1276,.493,212,596,.356,527,747,.705,419,873,1292,455,221,120,438,517,2421,67.3,1458.0,2008.0
xavier,37.0,7425.0,936,1973,.474,654,1252,.522,282,721,.391,626,836,.749,412,910,1322,564,206,125,480,643,2780,75.1,1462.0,2008.0
arkansas,35.0,7025.0,936,2001,.468,729,1394,.523,207,607,.341,514,758,.678,446,828,1274,505,241,182,531,662,2593,74.1,1116.0,2008.0
butler,34.0,,776,1729,.449,457,890,.513,319,839,.380,468,635,.737,308,708,1016,445,221,83,352,588,2339,68.8,1139.0,2008.0
davidson,36.0,,1032,2199,.469,704,1298,.542,328,901,.364,411,573,.717,417,885,1302,615,290,114,426,654,2803,77.9,1172.0,2008.0
georgetown,34.0,6850.0,855,1744,.490,586,1043,.562,269,701,.384,388,593,.654,335,855,1190,527,236,163,458,600,2367,69.6,1207.0,2008.0
louisville,36.0,7225.0,932,2011,.463,660,1233,.535,272,778,.350,475,734,.647,413,925,1338,542,289,178,491,659,2611,72.5,1257.0,2008.0
memphis,40.0,8050.0,1143,2454,.466,841,1589,.529,302,865,.349,608,991,.614,565,1055,1620,637,337,244,470,691,3196,79.9,1272.0,2008.0
miami-fl,34.0,6850.0,867,1985,.437,631,1372,.460,236,613,.385,572,766,.747,433,860,1293,451,202,157,454,638,2542,74.8,1274.0,2008.0
mississippi-state,34.0,6875.0,885,1922,.460,650,1219,.533,235,703,.334,484,749,.646,410,975,1385,448,199,267,509,568,2489,73.2,1280.0,2008.0
north-carolina,39.0,7900.0,1250,2564,.488,1034,1984,.521,216,580,.372,738,975,.757,605,1090,1695,656,318,174,560,658,3454,88.6,1314.0,2008.0
oklahoma,35.0,7075.0,831,1880,.442,611,1248,.490,220,632,.348,496,728,.681,391,849,1240,436,226,135,451,595,2378,67.9,1328.0,2008.0
san-diego,36.0,,868,1925,.451,691,1405,.492,177,520,.340,452,673,.672,384,822,1206,476,250,113,538,629,2365,65.7,1360.0,2008.0
siena,34.0,6875.0,928,2058,.451,689,1432,.481,239,626,.382,518,752,.689,390,758,1148,489,320,119,385,526,2613,76.9,1373.0,2008.0
tennessee,36.0,,1035,2258,.458,723,1383,.523,312,875,.357,564,856,.659,501,857,1358,637,334,119,474,749,2946,81.8,1397.0,2008.0
texas,38.0,,1032,2285,.452,723,1485,.487,309,800,.386,495,725,.683,496,952,1448,501,228,198,359,629,2868,75.5,1400.0,2008.0
villanova,35.0,7000.0,868,2013,.431,626,1310,.478,242,703,.344,569,783,.727,457,800,1257,466,283,98,503,727,2547,72.8,1437.0,2008.0
western-kentucky,36.0,,993,2106,.472,723,1419,.510,270,687,.393,529,755,.701,455,807,1262,458,288,135,514,768,2785,77.4,1443.0,2008.0
coppin-state,37.0,7525.0,775,1940,.399,628,1474,.426,147,466,.315,515,721,.714,409,749,1158,347,261,78,539,693,2212,59.8,1164.0,2008.0
belmont,34.0,6900.0,938,2078,.451,581,1099,.529,357,979,.365,481,689,.698,424,824,1248,587,290,65,498,626,2714,79.8,1125.0,2008.0
portland-state,33.0,6675.0,846,1822,.464,552,1073,.514,294,749,.393,452,668,.677,381,748,1129,521,231,108,484,591,2438,73.9,1340.0,2008.0
southern-california,33.0,6675.0,820,1710,.480,636,1234,.515,184,476,.387,453,661,.685,305,801,1106,409,188,145,482,530,2277,69.0,1425.0,2008.0
kentucky,31.0,6300.0,735,1566,.469,553,1073,.515,182,493,.369,472,644,.733,301,737,1038,395,206,149,490,586,2124,68.5,1246.0,2008.0
temple,34.0,,857,1829,.469,591,1108,.533,266,721,.369,477,645,.740,302,806,1108,510,214,148,432,601,2457,72.3,1396.0,2008.0
george-mason,34.0,,827,1778,.465,622,1187,.524,205,591,.347,497,707,.703,340,830,1170,445,189,108,406,525,2356,69.3,1206.0,2008.0
oral-roberts,33.0,6650.0,785,1783,.440,562,1179,.477,223,604,.369,489,730,.670,371,811,1182,445,206,132,431,554,2282,69.2,1331.0,2008.0
baylor,32.0,,899,1979,.454,624,1252,.498,275,727,.378,528,711,.743,384,812,1196,388,237,138,403,665,2601,81.3,1124.0,2008.0
cornell,28.0,5625.0,758,1562,.485,530,1004,.528,228,558,.409,392,515,.761,258,681,939,427,170,88,381,510,2136,76.3,1165.0,2008.0
brigham-young,35.0,7025.0,906,1970,.460,621,1206,.515,285,764,.373,483,737,.655,365,986,1351,587,207,135,492,618,2580,73.7,1140.0,2008.0
mississippi-valley-state,33.0,6625.0,698,1755,.398,551,1319,.418,147,436,.337,493,727,.678,389,718,1107,379,206,90,473,582,2036,61.7,1290.0,2008.0
kent-state,35.0,7025.0,839,1809,.464,637,1258,.506,202,551,.367,532,745,.714,385,781,1166,485,300,134,516,653,2412,68.9,1245.0,2008.0
winthrop,34.0,6825.0,795,1814,.438,578,1228,.471,217,586,.370,398,673,.591,393,802,1195,435,284,124,439,591,2205,64.9,1457.0,2008.0
arizona,34.0,6875.0,843,1765,.478,622,1199,.519,221,566,.390,536,716,.749,281,771,1052,526,189,120,414,556,2443,71.9,1112.0,2008.0
cal-state-fullerton,33.0,6625.0,974,2060,.473,689,1319,.522,285,741,.385,467,665,.702,391,791,1182,505,296,51,445,629,2700,81.8,1168.0,2008.0
georgia,34.0,,840,1956,.429,636,1337,.476,204,619,.330,430,633,.679,451,844,1295,396,228,116,505,612,2314,68.1,1208.0,2008.0
indiana,33.0,6675.0,839,1814,.463,618,1181,.523,221,633,.349,577,760,.759,386,861,1247,436,233,125,449,575,2476,75.0,1231.0,2008.0
south-alabama,33.0,6650.0,840,1774,.474,620,1167,.531,220,607,.362,578,821,.704,404,817,1221,509,201,100,457,569,2478,75.1,1375.0,2008.0
gonzaga,33.0,6700.0,892,1838,.485,672,1252,.537,220,586,.375,520,730,.712,369,866,1235,479,253,153,473,584,2524,76.5,1211.0,2008.0
maryland-baltimore-county,33.0,6675.0,869,1928,.451,621,1291,.481,248,637,.389,464,640,.725,371,755,1126,500,209,114,318,537,2450,74.2,1420.0,2008.0
boise-state,34.0,,994,1956,.508,723,1266,.571,271,690,.393,508,768,.661,335,883,1218,605,215,80,534,591,2767,81.4,1129.0,2008.0
texas-arlington,33.0,,868,1820,.477,667,1243,.537,201,577,.348,485,741,.655,352,897,1249,467,218,87,565,649,2422,73.4,1426.0,2008.0
saint-marys-ca,32.0,6475.0,845,1843,.458,591,1137,.520,254,706,.360,477,722,.661,385,830,1215,468,230,169,439,557,2421,75.7,1388.0,2008.0
oregon,32.0,6475.0,858,1788,.480,579,1077,.538,279,711,.392,455,656,.694,327,766,1093,475,148,81,402,586,2450,76.6,1332.0,2008.0
saint-josephs,34.0,6850.0,859,1800,.477,612,1160,.528,247,640,.386,519,715,.726,337,749,1086,502,242,154,432,598,2484,73.1,1386.0,2008.0
connecticut,33.0,,868,1880,.462,700,1415,.495,168,465,.361,652,905,.720,449,934,1383,488,189,285,451,506,2556,77.5,1163.0,2008.0
vanderbilt,34.0,6975.0,928,1995,.465,625,1235,.506,303,760,.399,562,765,.735,359,838,1197,606,207,118,494,623,2721,80.0,1435.0,2008.0
american,33.0,,698,1586,.440,438,948,.462,260,638,.408,484,655,.739,321,743,1064,390,152,87,458,587,2140,64.8,1110.0,2008.0
austin-peay,35.0,,855,1917,.446,582,1202,.484,273,715,.382,607,850,.714,362,745,1107,501,335,75,440,616,2590,74.0,1122.0,2008.0
clemson,34.0,,1000,2191,.456,729,1463,.498,271,728,.372,422,677,.623,536,769,1305,535,334,185,505,664,2693,79.2,1155.0,2008.0
drake,33.0,6650.0,816,1829,.446,506,989,.512,310,840,.369,498,656,.759,399,729,1128,485,252,85,390,492,2440,73.9,1179.0,2008.0
morehead-state,36.0,,865,1978,.437,677,1413,.479,188,565,.333,593,823,.721,498,902,1400,464,239,139,557,657,2511,69.8,1287.0,2009.0
connecticut,36.0,7375.0,996,2102,.474,831,1618,.514,165,484,.341,662,976,.678,511,1048,1559,567,209,280,458,471,2819,78.3,1163.0,2009.0
duke,37.0,7425.0,971,2186,.444,704,1420,.496,267,766,.349,658,904,.728,490,858,1348,492,311,146,454,671,2867,77.5,1181.0,2009.0
gonzaga,34.0,6850.0,967,1982,.488,716,1339,.535,251,643,.390,499,696,.717,345,931,1276,512,246,174,386,551,2684,78.9,1211.0,2009.0
louisiana-state,35.0,7050.0,937,2093,.448,724,1521,.476,213,572,.372,530,740,.716,475,890,1365,529,267,212,425,609,2617,74.8,1261.0,2009.0
maryland,35.0,7075.0,924,2179,.424,723,1575,.459,201,604,.333,463,611,.758,464,810,1274,511,268,145,428,582,2512,71.8,1268.0,2009.0
memphis,37.0,7425.0,979,2176,.450,757,1495,.506,222,681,.326,599,868,.690,498,954,1452,526,328,222,464,654,2779,75.1,1272.0,2009.0
michigan,35.0,7100.0,812,1910,.425,507,998,.508,305,912,.334,412,544,.757,336,751,1087,542,223,92,402,535,2341,66.9,1276.0,2009.0
north-carolina,38.0,7625.0,1205,2509,.480,941,1827,.515,264,682,.387,739,983,.752,556,1038,1594,685,325,196,472,608,3413,89.8,1314.0,2009.0
oklahoma,36.0,7225.0,982,1997,.492,740,1308,.566,242,689,.351,627,929,.675,435,967,1402,521,249,156,500,616,2833,78.7,1328.0,2009.0
purdue,37.0,7475.0,914,2071,.441,670,1367,.490,244,704,.347,483,687,.703,363,908,1271,552,265,176,426,650,2555,69.1,1345.0,2009.0
texas,35.0,7050.0,917,2063,.444,751,1497,.502,166,566,.293,532,797,.668,496,863,1359,448,217,187,442,674,2532,72.3,1400.0,2009.0
texas-am,34.0,,822,1831,.449,620,1271,.488,202,560,.361,594,856,.694,422,827,1249,427,164,133,432,585,2440,71.8,1401.0,2009.0
ucla,35.0,7025.0,967,1973,.490,705,1317,.535,262,656,.399,446,616,.724,395,756,1151,541,292,110,440,598,2642,75.5,1417.0,2009.0
villanova,38.0,,990,2193,.451,743,1492,.498,247,701,.352,692,919,.753,477,972,1449,551,300,128,505,735,2919,76.8,1437.0,2009.0
western-kentucky,34.0,6800.0,871,1929,.452,605,1215,.498,266,714,.373,446,647,.689,432,819,1251,454,193,111,452,587,2454,72.2,1443.0,2009.0
washington,35.0,,977,2136,.457,831,1703,.488,146,433,.337,650,929,.700,532,905,1437,458,259,95,515,683,2750,78.6,1449.0,2009.0
arizona,35.0,7025.0,897,1892,.474,685,1344,.510,212,548,.387,523,709,.738,387,796,1183,500,217,104,442,548,2529,72.3,1112.0,2009.0
arizona-state,35.0,7100.0,825,1718,.480,537,940,.571,288,778,.370,490,665,.737,288,797,1085,544,201,72,401,557,2428,69.4,1113.0,2009.0
cleveland-state,37.0,7400.0,882,2043,.432,702,1465,.479,180,578,.311,511,729,.701,441,826,1267,512,320,118,454,680,2455,66.4,1156.0,2009.0
dayton,35.0,7050.0,831,1972,.421,641,1393,.460,190,579,.328,487,752,.648,484,844,1328,485,227,124,475,672,2339,66.8,1173.0,2009.0
kansas,35.0,7025.0,945,1979,.478,728,1394,.522,217,585,.371,567,782,.725,421,950,1371,555,239,155,508,664,2674,76.4,1242.0,2009.0
louisville,37.0,,1001,2189,.457,696,1362,.511,305,827,.369,441,687,.642,464,931,1395,625,335,223,508,625,2748,74.3,1257.0,2009.0
marquette,35.0,7025.0,914,2023,.452,671,1322,.508,243,701,.347,668,918,.728,425,822,1247,526,275,100,408,623,2739,78.3,1266.0,2009.0
michigan-state,38.0,7600.0,962,2135,.451,761,1568,.485,201,567,.354,612,877,.698,533,949,1482,611,248,107,532,734,2737,72.0,1277.0,2009.0
missouri,38.0,7600.0,1124,2381,.472,861,1635,.527,263,746,.353,585,871,.672,486,907,1393,699,388,140,449,758,3096,81.5,1281.0,2009.0
oklahoma-state,35.0,7050.0,948,2059,.460,621,1208,.514,327,851,.384,607,812,.748,346,877,1223,446,266,82,431,745,2830,80.9,1329.0,2009.0
pittsburgh,36.0,7200.0,1040,2174,.478,815,1534,.531,225,640,.352,482,713,.676,533,900,1433,633,246,139,436,585,2787,77.4,1338.0,2009.0
siena,35.0,7075.0,1007,2157,.467,823,1599,.515,184,558,.330,511,769,.664,438,835,1273,534,309,159,462,521,2709,77.4,1373.0,2009.0
syracuse,38.0,,1110,2277,.487,854,1534,.557,256,743,.345,570,884,.645,482,1023,1505,687,296,194,583,580,3046,80.2,1393.0,2009.0
southern-california,35.0,,872,1843,.473,743,1447,.513,129,396,.326,524,778,.674,409,838,1247,438,224,165,487,584,2397,68.5,1425.0,2009.0
wisconsin,33.0,6700.0,735,1686,.436,522,1094,.477,213,592,.360,423,583,.726,317,703,1020,393,163,86,330,532,2106,63.8,1458.0,2009.0
xavier,35.0,,847,1846,.459,608,1239,.491,239,607,.394,575,851,.676,420,958,1378,464,185,178,511,653,2508,71.7,1462.0,2009.0
alabama-state,32.0,,816,1752,.466,635,1202,.528,181,550,.329,389,614,.634,358,772,1130,445,182,153,435,558,2202,68.8,1106.0,2009.0
chattanooga,35.0,7075.0,877,2002,.438,588,1181,.498,289,821,.352,614,935,.657,438,936,1374,477,218,79,551,648,2657,75.9,1151.0,2009.0
binghamton,32.0,6475.0,778,1764,.441,586,1189,.493,192,575,.334,491,733,.670,357,744,1101,383,227,134,431,652,2239,70.0,1127.0,2009.0
akron,36.0,7275.0,823,1969,.418,565,1193,.474,258,776,.332,499,705,.708,424,775,1199,446,270,80,490,745,2403,66.8,1103.0,2009.0
butler,32.0,6400.0,705,1609,.438,448,878,.510,257,731,.352,501,692,.724,328,766,1094,417,193,102,400,568,2168,67.8,1139.0,2009.0
california,33.0,6700.0,892,1848,.483,682,1356,.503,210,492,.427,478,633,.755,333,780,1113,509,159,66,399,560,2472,74.9,1143.0,2009.0
cal-state-northridge,31.0,6250.0,821,1808,.454,606,1199,.505,215,609,.353,425,611,.696,403,747,1150,430,276,83,549,683,2282,73.6,1169.0,2009.0
clemson,32.0,6425.0,912,1971,.463,656,1287,.510,256,684,.374,427,621,.688,462,727,1189,478,298,187,456,575,2507,78.3,1155.0,2009.0
radford,33.0,6725.0,884,1917,.461,721,1454,.496,163,463,.352,560,825,.679,418,954,1372,466,225,154,539,607,2491,75.5,1347.0,2009.0
morgan-state,35.0,,857,2047,.419,676,1510,.448,181,537,.337,438,675,.649,508,822,1330,393,232,110,456,673,2333,66.7,1288.0,2009.0
northern-iowa,34.0,6950.0,766,1692,.453,549,1064,.516,217,628,.346,541,718,.753,297,843,1140,418,146,83,397,619,2290,67.4,1320.0,2009.0
minnesota,33.0,6625.0,782,1772,.441,594,1197,.496,188,575,.327,437,611,.715,397,739,1136,466,274,201,477,588,2189,66.3,1278.0,2009.0
brigham-young,33.0,6625.0,909,1879,.484,671,1255,.535,238,624,.381,488,669,.729,302,894,1196,537,241,119,375,607,2544,77.1,1140.0,2009.0
virginia-commonwealth,34.0,,866,1878,.461,644,1277,.504,222,601,.369,486,689,.705,362,790,1152,469,257,155,431,654,2440,71.8,1433.0,2009.0
american,32.0,6450.0,751,1614,.465,521,999,.522,230,615,.374,333,514,.648,302,744,1046,421,176,79,422,581,2065,64.5,1110.0,2009.0
illinois,34.0,6850.0,859,1865,.461,671,1328,.505,188,537,.350,298,419,.711,320,807,1127,595,199,122,420,521,2204,64.8,1228.0,2009.0
mississippi-state,36.0,7325.0,890,2058,.432,594,1239,.479,296,819,.361,601,847,.710,407,977,1384,447,250,271,517,604,2677,74.4,1280.0,2009.0
utah,34.0,6850.0,819,1727,.474,577,1072,.538,242,655,.369,541,693,.781,279,914,1193,458,171,166,469,632,2421,71.2,1428.0,2009.0
temple,34.0,,846,1908,.443,588,1205,.488,258,703,.367,383,547,.700,376,872,1248,527,189,141,426,581,2333,68.6,1396.0,2009.0
wake-forest,31.0,,906,1849,.490,780,1455,.536,126,394,.320,572,804,.711,390,872,1262,405,258,176,492,584,2510,81.0,1448.0,2009.0
west-virginia,35.0,7025.0,886,2067,.429,655,1364,.480,231,703,.329,518,742,.698,532,808,1340,530,233,159,420,661,2521,72.0,1452.0,2009.0
north-dakota-state,33.0,6725.0,943,1936,.487,705,1358,.519,238,578,.412,535,724,.739,363,808,1171,486,230,108,370,539,2659,80.6,1295.0,2009.0
utah-state,35.0,,899,1813,.496,677,1250,.542,222,563,.394,514,695,.740,365,837,1202,566,168,88,393,539,2534,72.4,1429.0,2009.0
robert-morris,35.0,,880,1859,.473,654,1286,.509,226,573,.394,481,683,.704,353,808,1161,536,301,121,530,693,2467,70.5,1352.0,2009.0
cornell,31.0,,821,1736,.473,580,1149,.505,241,587,.411,398,545,.730,321,784,1105,482,203,121,398,556,2281,73.6,1165.0,2009.0
tennessee,34.0,6825.0,957,2105,.455,728,1377,.529,229,728,.315,522,772,.676,485,831,1316,554,225,124,452,647,2665,78.4,1397.0,2009.0
east-tennessee-state,34.0,,944,2044,.462,749,1454,.515,195,590,.331,574,810,.709,395,895,1290,429,287,131,477,622,2657,78.1,1190.0,2009.0
ohio-state,33.0,6675.0,778,1618,.481,562,1042,.539,216,576,.375,434,619,.701,266,758,1024,440,194,175,439,501,2206,66.8,1326.0,2009.0
stephen-f-austin,32.0,6475.0,786,1795,.438,609,1234,.494,177,561,.316,350,539,.649,311,815,1126,421,200,100,384,582,2099,65.6,1372.0,2009.0
boston-college,34.0,6850.0,885,2000,.443,668,1351,.494,217,649,.334,541,733,.738,485,774,1259,503,208,147,457,614,2528,74.4,1130.0,2009.0
florida-state,35.0,7050.0,820,1886,.435,604,1255,.481,216,631,.342,536,739,.725,399,854,1253,423,284,202,548,657,2392,68.3,1199.0,2009.0
portland-state,33.0,,861,1899,.453,544,1064,.511,317,835,.380,378,557,.679,388,728,1116,503,245,93,453,553,2417,73.2,1340.0,2009.0
arkansas-pine-bluff,34.0,6900.0,725,1778,.408,584,1312,.445,141,466,.303,575,861,.668,422,864,1286,421,229,121,569,764,2166,63.7,1115.0,2010.0
baylor,36.0,7250.0,993,2040,.487,738,1378,.536,255,662,.385,530,731,.725,443,965,1408,508,237,242,491,639,2771,77.0,1124.0,2010.0
butler,38.0,7625.0,845,1911,.442,585,1150,.509,260,761,.342,661,896,.738,353,888,1241,464,267,86,456,685,2611,68.7,1139.0,2010.0
brigham-young,36.0,7250.0,1025,2120,.483,733,1420,.516,292,700,.417,650,823,.790,367,965,1332,567,307,126,417,621,2992,83.1,1140.0,2010.0
kansas,36.0,7250.0,1033,2111,.489,771,1463,.527,262,648,.404,609,871,.699,468,989,1457,609,301,232,470,658,2937,81.6,1242.0,2010.0
kansas-state,37.0,7500.0,981,2182,.450,728,1479,.492,253,703,.360,734,1098,.668,559,878,1437,541,274,187,529,828,2949,79.7,1243.0,2010.0
kentucky,38.0,7675.0,1066,2228,.478,835,1531,.545,231,697,.331,649,971,.668,538,1046,1584,573,279,273,538,641,3012,79.3,1246.0,2010.0
murray-state,36.0,7200.0,978,1961,.499,752,1362,.552,226,599,.377,571,821,.695,439,880,1319,556,347,196,527,618,2753,76.5,1293.0,2010.0
new-mexico,35.0,7050.0,887,2023,.438,614,1284,.478,273,739,.369,608,909,.669,458,889,1347,497,232,120,387,615,2655,75.9,1307.0,2010.0
northern-iowa,35.0,7000.0,747,1741,.429,514,1082,.475,233,659,.354,489,645,.758,333,797,1130,367,198,70,372,556,2216,63.3,1320.0,2010.0
ohio,37.0,7550.0,925,2153,.430,647,1394,.464,278,759,.366,635,883,.719,443,928,1371,524,278,97,473,696,2763,74.7,1325.0,2010.0
old-dominion,36.0,7225.0,922,2061,.447,756,1538,.492,166,523,.317,405,625,.648,540,854,1394,554,282,105,457,560,2415,67.1,1330.0,2010.0
saint-marys-ca,34.0,6825.0,944,1950,.484,660,1251,.528,284,699,.406,496,652,.761,370,874,1244,543,168,176,394,560,2668,78.5,1388.0,2010.0
tennessee,37.0,7425.0,991,2174,.456,773,1493,.518,218,681,.320,520,775,.671,441,912,1353,530,290,136,490,733,2720,73.5,1397.0,2010.0
villanova,33.0,6650.0,899,1962,.458,647,1286,.503,252,676,.373,650,861,.755,441,831,1272,448,259,133,452,731,2700,81.8,1437.0,2010.0
wake-forest,31.0,6350.0,811,1869,.434,677,1434,.472,134,435,.308,501,762,.657,463,843,1306,369,221,162,471,624,2257,72.8,1448.0,2010.0
washington,36.0,7225.0,1004,2212,.454,813,1644,.495,191,568,.336,652,905,.720,476,888,1364,515,264,151,460,766,2851,79.2,1449.0,2010.0
california,35.0,7025.0,966,2028,.476,738,1419,.520,228,609,.374,543,717,.757,395,846,1241,500,198,86,421,593,2703,77.2,1143.0,2010.0
cornell,34.0,6850.0,913,1894,.482,587,1135,.517,326,759,.430,393,538,.730,349,800,1149,543,243,122,414,598,2596,76.4,1165.0,2010.0
duke,40.0,8000.0,1049,2375,.442,748,1593,.470,301,782,.385,682,899,.759,569,991,1560,555,266,162,429,722,3079,77.0,1181.0,2010.0
georgia-tech,36.0,7225.0,948,2064,.459,735,1477,.498,213,587,.363,512,779,.657,464,966,1430,508,288,190,574,670,2621,72.8,1210.0,2010.0
gonzaga,34.0,6875.0,912,1856,.491,730,1340,.545,182,516,.353,608,916,.664,358,928,1286,456,227,142,444,614,2614,76.9,1211.0,2010.0
maryland,33.0,6675.0,966,2052,.471,771,1542,.500,195,510,.382,502,689,.729,421,849,1270,545,256,154,383,554,2629,79.7,1268.0,2010.0
michigan-state,37.0,7425.0,974,2068,.471,787,1525,.516,187,543,.344,523,764,.685,487,939,1426,606,242,123,514,666,2658,71.8,1277.0,2010.0
missouri,34.0,6850.0,926,2104,.440,668,1403,.476,258,701,.368,517,714,.724,441,759,1200,522,371,160,432,656,2627,77.3,1281.0,2010.0
ohio-state,37.0,7450.0,983,1999,.492,707,1291,.548,276,708,.390,498,716,.696,325,909,1234,545,262,157,413,565,2740,74.1,1326.0,2010.0
pittsburgh,34.0,6950.0,809,1811,.447,628,1285,.489,181,526,.344,537,775,.693,420,849,1269,536,177,139,421,594,2336,68.7,1338.0,2010.0
purdue,35.0,7025.0,867,1957,.443,680,1369,.497,187,588,.318,546,755,.723,351,819,1170,493,248,162,381,651,2467,70.5,1345.0,2010.0
syracuse,35.0,7000.0,1042,2021,.516,798,1397,.571,244,624,.391,504,745,.677,417,920,1337,673,336,221,532,515,2832,80.9,1393.0,2010.0
texas-am,34.0,6850.0,813,1846,.440,603,1220,.494,210,626,.335,590,892,.661,400,852,1252,417,223,113,417,619,2426,71.4,1401.0,2010.0
west-virginia,38.0,7725.0,942,2190,.430,685,1428,.480,257,762,.337,611,868,.704,585,882,1467,589,213,155,451,686,2752,72.4,1452.0,2010.0
wisconsin,33.0,6650.0,776,1750,.443,530,1060,.500,246,690,.357,416,568,.732,320,736,1056,412,187,113,289,537,2214,67.1,1458.0,2010.0
xavier,35.0,7225.0,961,2082,.462,711,1418,.501,250,664,.377,621,873,.711,444,971,1415,494,235,132,452,662,2793,79.8,1462.0,2010.0
winthrop,33.0,6650.0,735,1934,.380,611,1434,.426,124,500,.248,448,696,.644,450,826,1276,346,283,135,402,622,2042,61.9,1457.0,2010.0
sam-houston-state,33.0,6650.0,909,1963,.463,622,1188,.524,287,775,.370,511,727,.703,410,837,1247,673,257,85,442,661,2616,79.3,1358.0,2010.0
texas-el-paso,33.0,6675.0,891,1879,.474,690,1293,.534,201,586,.343,501,744,.673,323,870,1193,488,288,120,435,643,2484,75.3,1431.0,2010.0
florida,34.0,6875.0,890,2006,.444,687,1358,.506,203,648,.313,472,671,.703,455,810,1265,479,243,94,423,501,2455,72.2,1196.0,2010.0
lehigh,33.0,6650.0,842,1853,.454,622,1302,.478,220,551,.399,574,799,.718,339,862,1201,495,203,85,429,589,2478,75.1,1250.0,2010.0
north-texas,33.0,6700.0,798,1748,.457,619,1210,.512,179,538,.333,662,921,.719,364,856,1220,394,144,94,485,590,2437,73.8,1317.0,2010.0
east-tennessee-state,35.0,7025.0,855,1978,.432,678,1403,.483,177,575,.308,537,815,.659,445,832,1277,382,293,112,519,673,2424,69.3,1190.0,2010.0
vanderbilt,33.0,6625.0,859,1829,.470,656,1277,.514,203,552,.368,616,854,.721,361,836,1197,436,188,171,448,632,2537,76.9,1435.0,2010.0
montana,32.0,6400.0,791,1636,.483,581,1110,.523,210,526,.399,436,603,.723,283,765,1048,396,206,106,390,571,2228,69.6,1285.0,2010.0
nevada-las-vegas,34.0,6850.0,899,1950,.461,668,1255,.532,231,695,.332,456,637,.716,337,812,1149,551,266,117,395,691,2485,73.1,1424.0,2010.0
georgetown,34.0,6800.0,905,1815,.499,693,1267,.547,212,548,.387,478,672,.711,333,799,1132,524,237,161,473,579,2500,73.5,1207.0,2010.0
notre-dame,35.0,7075.0,918,1953,.470,657,1280,.513,261,673,.388,538,744,.723,402,848,1250,585,194,104,362,530,2635,75.3,1323.0,2010.0
richmond,35.0,7150.0,868,1943,.447,618,1239,.499,250,704,.355,441,630,.700,304,835,1139,442,289,158,384,634,2427,69.3,1350.0,2010.0
san-diego-state,34.0,6875.0,875,1846,.474,696,1282,.543,179,564,.317,460,741,.621,444,813,1257,458,251,156,453,552,2389,70.3,1361.0,2010.0
robert-morris,35.0,7025.0,815,1868,.436,618,1322,.467,197,546,.361,572,859,.666,412,815,1227,433,267,80,520,757,2399,68.5,1352.0,2010.0
texas,34.0,6875.0,1005,2158,.466,810,1592,.509,195,566,.345,556,878,.633,503,922,1425,489,269,194,464,670,2761,81.2,1400.0,2010.0
marquette,34.0,6900.0,861,1890,.456,587,1226,.479,274,664,.413,489,660,.741,343,728,1071,516,269,72,353,580,2485,73.1,1266.0,2010.0
louisville,33.0,6675.0,876,1960,.447,614,1183,.519,262,777,.337,491,700,.701,478,739,1217,511,258,135,453,663,2505,75.9,1257.0,2010.0
temple,35.0,7050.0,851,1942,.438,647,1337,.484,204,605,.337,367,533,.689,377,904,1281,515,163,104,358,521,2273,64.9,1396.0,2010.0
oklahoma-state,33.0,6625.0,839,1861,.451,565,1077,.525,274,784,.349,485,679,.714,327,842,1169,413,214,84,418,664,2437,73.8,1329.0,2010.0
florida-state,32.0,6425.0,783,1734,.452,597,1177,.507,186,557,.334,431,669,.644,406,805,1211,446,267,200,528,575,2183,68.2,1199.0,2010.0
houston,35.0,7050.0,958,2282,.420,668,1468,.455,290,814,.356,545,768,.710,440,745,1185,435,329,103,315,652,2751,78.6,1222.0,2010.0
new-mexico-state,34.0,6800.0,919,1997,.460,632,1223,.517,287,774,.371,537,767,.700,358,854,1212,484,203,111,437,595,2662,78.3,1308.0,2010.0
clemson,32.0,6400.0,851,1878,.453,635,1247,.509,216,631,.342,432,654,.661,420,758,1178,453,301,151,480,564,2350,73.4,1155.0,2010.0
california-santa-barbara,30.0,6025.0,674,1522,.443,469,978,.480,205,544,.377,475,698,.681,268,716,984,414,202,92,460,572,2028,67.6,1364.0,2010.0
oakland,35.0,7000.0,920,2053,.448,714,1413,.505,206,640,.322,630,876,.719,477,867,1344,461,236,169,485,632,2676,76.5,1324.0,2010.0
siena,34.0,6850.0,930,2048,.454,770,1550,.497,160,498,.321,534,793,.673,442,868,1310,486,298,119,418,471,2554,75.1,1373.0,2010.0
vermont,35.0,7025.0,826,1884,.438,660,1360,.485,166,524,.317,639,930,.687,433,858,1291,423,239,141,487,635,2457,70.2,1436.0,2010.0
utah-state,35.0,7025.0,941,1928,.488,699,1343,.520,242,585,.414,435,574,.758,362,876,1238,584,162,123,358,562,2559,73.1,1429.0,2010.0
morgan-state,37.0,7500.0,960,2239,.429,755,1622,.465,205,617,.332,688,983,.700,568,920,1488,461,243,152,499,782,2813,76.0,1288.0,2010.0
wofford,35.0,7025.0,825,1873,.440,622,1293,.481,203,580,.350,555,830,.669,402,841,1243,469,242,74,416,621,2408,68.8,1459.0,2010.0
minnesota,35.0,7075.0,912,1949,.468,666,1332,.500,246,617,.399,463,661,.700,375,862,1237,583,273,199,427,579,2533,72.4,1278.0,2010.0
clemson,34.0,6850.0,810,1827,.443,593,1197,.495,217,630,.344,493,703,.701,384,793,1177,445,272,161,449,624,2330,68.5,1155.0,2011.0
north-carolina-asheville,34.0,6951.0,881,1950,.452,713,1435,.497,168,515,.326,576,810,.711,400,813,1213,492,310,152,506,664,2506,73.7,1421.0,2011.0
texas-san-antonio,34.0,6800.0,802,1871,.429,568,1204,.472,234,667,.351,546,774,.705,362,824,1186,430,240,76,461,657,2384,70.1,1427.0,2011.0
virginia-commonwealth,40.0,8100.0,968,2228,.434,629,1311,.480,339,917,.370,589,824,.715,428,864,1292,583,328,140,452,735,2864,71.6,1433.0,2011.0
butler,38.0,7700.0,919,2122,.433,630,1300,.485,289,822,.352,580,799,.726,431,906,1337,452,226,61,416,718,2707,71.2,1139.0,2011.0
brigham-young,37.0,7475.0,1019,2267,.449,707,1402,.504,312,865,.361,662,865,.765,420,1005,1425,538,298,150,404,647,3012,81.4,1140.0,2011.0
cincinnati,35.0,7025.0,848,1939,.437,628,1288,.488,220,651,.338,496,742,.668,454,783,1237,497,258,129,401,605,2412,68.9,1153.0,2011.0
connecticut,41.0,8350.0,1053,2429,.434,819,1718,.477,234,711,.329,627,822,.763,570,1056,1626,534,259,228,466,646,2967,72.4,1163.0,2011.0
florida,37.0,7575.0,968,2083,.465,735,1422,.517,233,661,.352,498,744,.669,467,917,1384,521,221,131,452,545,2667,72.1,1196.0,2011.0
gonzaga,35.0,7050.0,932,1947,.479,729,1399,.521,203,548,.370,617,810,.762,398,916,1314,542,254,132,474,649,2684,76.7,1211.0,2011.0
kansas-state,34.0,6800.0,849,1939,.438,612,1308,.468,237,631,.376,542,828,.655,490,790,1280,474,208,154,498,692,2477,72.9,1243.0,2011.0
kentucky,38.0,7625.0,1002,2183,.459,721,1476,.488,281,707,.397,560,789,.710,445,975,1420,482,211,239,406,601,2845,74.9,1246.0,2011.0
morehead-state,35.0,7069.0,851,1874,.454,647,1273,.508,204,601,.339,506,751,.674,484,827,1311,424,300,110,525,653,2412,68.9,1287.0,2011.0
pittsburgh,34.0,6825.0,886,1866,.475,684,1354,.505,202,512,.395,540,805,.671,484,875,1359,595,160,111,397,610,2514,73.9,1338.0,2011.0
richmond,37.0,7450.0,922,2007,.459,635,1272,.499,287,735,.390,446,649,.687,344,878,1222,548,220,155,383,587,2577,69.6,1350.0,2011.0
san-diego-state,37.0,7450.0,991,2141,.463,768,1502,.511,223,639,.349,455,653,.697,472,924,1396,499,227,170,402,542,2660,71.9,1361.0,2011.0
temple,34.0,6875.0,868,1943,.447,662,1360,.487,206,583,.353,458,656,.698,374,844,1218,511,231,156,368,538,2400,70.6,1396.0,2011.0
ucla,34.0,6876.0,830,1824,.455,657,1295,.507,173,529,.327,549,808,.679,405,860,1265,493,186,198,502,594,2382,70.1,1417.0,2011.0
west-virginia,33.0,6600.0,783,1826,.429,577,1215,.475,206,611,.337,531,747,.711,469,758,1227,491,154,136,397,598,2303,69.8,1452.0,2011.0
wisconsin,34.0,6849.0,798,1808,.441,520,1064,.489,278,744,.374,436,533,.818,355,733,1088,442,121,105,258,522,2310,67.9,1458.0,2011.0
arizona,38.0,7700.0,969,2064,.469,673,1319,.510,296,745,.397,671,899,.746,408,911,1319,536,197,98,484,707,2905,76.4,1112.0,2011.0
duke,37.0,7400.0,1040,2206,.471,749,1428,.525,291,778,.374,622,826,.753,446,953,1399,529,269,162,447,657,2993,80.9,1181.0,2011.0
florida-state,34.0,6825.0,827,1903,.435,615,1269,.485,212,634,.334,482,725,.665,422,910,1332,423,288,203,541,651,2348,69.1,1199.0,2011.0
george-mason,34.0,6875.0,876,1861,.471,649,1287,.504,227,574,.395,495,718,.689,364,824,1188,483,224,110,376,581,2474,72.8,1206.0,2011.0
illinois,34.0,6825.0,894,1910,.468,662,1310,.505,232,600,.387,393,539,.729,342,836,1178,568,188,152,434,597,2413,71.0,1228.0,2011.0
kansas,38.0,7625.0,1114,2193,.508,843,1483,.568,271,710,.382,585,862,.679,449,1026,1475,674,295,153,507,666,3084,81.2,1242.0,2011.0
marquette,37.0,7425.0,973,2094,.465,782,1547,.505,191,547,.349,645,927,.696,457,872,1329,574,265,134,455,622,2782,75.2,1266.0,2011.0
michigan,35.0,7050.0,847,1889,.448,564,1085,.520,283,804,.352,351,502,.699,289,826,1115,480,168,69,351,587,2328,66.5,1276.0,2011.0
north-carolina,37.0,7424.0,1044,2317,.451,854,1738,.491,190,579,.328,590,878,.672,525,1053,1578,573,232,204,493,597,2868,77.5,1314.0,2011.0
notre-dame,34.0,6900.0,843,1832,.460,570,1124,.507,273,708,.386,599,827,.724,371,890,1261,563,156,128,364,517,2558,75.2,1323.0,2011.0
ohio-state,37.0,7425.0,1017,2059,.494,732,1385,.529,285,674,.423,535,763,.701,419,858,1277,587,263,118,375,519,2854,77.1,1326.0,2011.0
purdue,34.0,6825.0,875,1957,.447,640,1312,.488,235,645,.364,481,673,.715,380,827,1207,538,211,141,354,605,2466,72.5,1345.0,2011.0
syracuse,35.0,7050.0,936,1983,.472,714,1355,.527,222,628,.354,474,713,.665,429,879,1308,566,304,231,433,544,2568,73.4,1393.0,2011.0
texas,36.0,7250.0,954,2099,.455,753,1564,.481,201,535,.376,592,905,.654,494,958,1452,485,207,183,425,616,2701,75.0,1400.0,2011.0
washington,35.0,7050.0,1061,2260,.469,756,1439,.525,305,821,.371,480,712,.674,488,879,1367,593,234,179,426,718,2907,83.1,1449.0,2011.0
alabama-birmingham,31.0,6350.0,756,1725,.438,517,1027,.503,239,698,.342,368,513,.717,352,757,1109,420,164,97,387,514,2119,68.4,1412.0,2011.0
arkansas-little-rock,36.0,7275.0,825,1938,.426,583,1323,.441,242,615,.393,565,819,.690,377,827,1204,433,212,89,428,740,2457,68.3,1114.0,2011.0
alabama-state,35.0,7050.0,728,1841,.395,563,1258,.448,165,583,.283,525,870,.603,460,811,1271,404,255,163,551,777,2146,61.3,1106.0,2011.0
southern-california,34.0,6825.0,813,1832,.444,609,1255,.485,204,577,.354,422,648,.651,340,813,1153,402,199,104,390,589,2252,66.2,1425.0,2011.0
old-dominion,34.0,6800.0,803,1828,.439,637,1323,.481,166,505,.329,459,687,.668,524,831,1355,485,234,146,424,503,2231,65.6,1330.0,2011.0
wofford,34.0,6950.0,883,1853,.477,686,1360,.504,197,493,.400,539,778,.693,372,736,1108,487,227,86,404,654,2502,73.6,1459.0,2011.0
missouri,34.0,6875.0,983,2145,.458,738,1476,.500,245,669,.366,537,727,.739,425,772,1197,558,329,171,431,689,2748,80.8,1281.0,2011.0
bucknell,34.0,6826.0,827,1855,.446,593,1270,.467,234,585,.400,499,633,.788,270,879,1149,491,160,106,380,612,2387,70.2,1137.0,2011.0
california-santa-barbara,32.0,6475.0,742,1636,.454,515,1025,.502,227,611,.372,459,610,.752,277,761,1038,457,233,133,456,611,2170,67.8,1364.0,2011.0
st-johns-ny,33.0,6625.0,807,1773,.455,664,1346,.493,143,427,.335,556,783,.710,354,714,1068,417,266,94,408,626,2313,70.1,1385.0,2011.0
utah-state,34.0,6850.0,840,1788,.470,634,1226,.517,206,562,.367,563,764,.737,363,903,1266,500,162,110,402,591,2449,72.0,1429.0,2011.0
princeton,32.0,6525.0,788,1696,.465,595,1165,.511,193,531,.363,446,609,.732,315,790,1105,427,191,134,389,551,2215,69.2,1343.0,2011.0
louisville,35.0,7125.0,949,2097,.453,640,1243,.515,309,854,.362,416,627,.663,434,838,1272,608,327,175,459,671,2623,74.9,1257.0,2011.0
vanderbilt,34.0,6875.0,848,1853,.458,585,1145,.511,263,708,.371,622,837,.743,370,885,1255,454,175,162,441,552,2581,75.9,1435.0,2011.0
northern-colorado,32.0,6400.0,731,1708,.428,477,1051,.454,254,657,.387,571,742,.770,376,774,1150,371,191,62,454,609,2287,71.5,1294.0,2011.0
penn-state,34.0,6800.0,767,1748,.439,551,1110,.496,216,638,.339,394,544,.724,337,731,1068,413,151,82,358,530,2144,63.1,1336.0,2011.0
michigan-state,34.0,6874.0,817,1894,.431,597,1274,.469,220,620,.355,484,691,.700,407,849,1256,509,219,167,454,648,2338,68.8,1277.0,2011.0
belmont,35.0,7050.0,944,2045,.462,617,1181,.522,327,864,.378,575,781,.736,451,807,1258,575,338,118,480,729,2790,79.7,1125.0,2011.0
memphis,35.0,7075.0,891,1975,.451,681,1336,.510,210,639,.329,532,782,.680,421,825,1246,512,297,183,535,712,2524,72.1,1272.0,2011.0
hampton,33.0,6700.0,746,1843,.405,533,1185,.450,213,658,.324,492,759,.648,367,803,1170,387,241,185,412,604,2197,66.6,1214.0,2011.0
texas-am,33.0,6700.0,758,1719,.441,577,1185,.487,181,534,.339,557,799,.697,412,781,1193,444,215,51,426,602,2254,68.3,1401.0,2011.0
villanova,33.0,6625.0,796,1819,.438,586,1215,.482,210,604,.348,582,769,.757,402,821,1223,450,208,125,392,578,2384,72.2,1437.0,2011.0
nevada-las-vegas,33.0,6625.0,842,1836,.459,658,1278,.515,184,558,.330,495,718,.689,368,783,1151,509,268,124,414,635,2363,71.6,1424.0,2011.0
boston-university,35.0,7025.0,749,1865,.402,484,1118,.433,265,747,.355,507,695,.729,414,835,1249,345,189,129,418,635,2270,64.9,1131.0,2011.0
xavier,32.0,6500.0,784,1700,.461,611,1174,.520,173,526,.329,565,756,.747,328,802,1130,424,174,98,386,551,2306,72.1,1462.0,2011.0
tennessee,34.0,6850.0,837,1941,.431,662,1358,.487,175,583,.300,527,770,.684,464,815,1279,443,250,126,454,662,2376,69.9,1397.0,2011.0
long-island-university,33.0,6654.0,928,2009,.462,699,1374,.509,229,635,.361,645,999,.646,479,899,1378,503,246,111,505,580,2730,82.7,1254.0,2011.0
akron,36.0,7325.0,892,2073,.430,609,1288,.473,283,785,.361,457,649,.704,363,875,1238,520,240,129,432,692,2524,70.1,1103.0,2011.0
saint-peters,34.0,6828.0,713,1782,.400,516,1209,.427,197,573,.344,446,693,.644,384,825,1209,383,263,154,511,662,2069,60.9,1389.0,2011.0
indiana-state,34.0,6900.0,769,1793,.429,534,1144,.467,235,649,.362,480,676,.710,352,820,1172,431,212,145,477,684,2253,66.3,1232.0,2011.0
oakland,35.0,7025.0,1052,2137,.492,765,1370,.558,287,767,.374,601,834,.721,451,915,1366,568,216,192,473,644,2992,85.5,1324.0,2011.0
georgetown,32.0,6426.0,809,1703,.475,586,1072,.547,223,631,.353,417,568,.734,324,757,1081,481,193,139,433,603,2258,70.6,1207.0,2011.0
georgia,33.0,6750.0,823,1822,.452,667,1366,.488,156,456,.342,465,667,.697,407,836,1243,495,211,162,444,541,2267,68.7,1208.0,2011.0
brigham-young,35.0,7000.0,977,2099,.465,744,1420,.524,233,679,.343,540,771,.700,381,842,1223,599,296,154,473,637,2727,77.9,1140.0,2012.0
western-kentucky,35.0,7050.0,769,1952,.394,574,1314,.437,195,638,.306,539,785,.687,449,724,1173,385,195,146,534,691,2272,64.9,1443.0,2012.0
south-florida,36.0,7250.0,772,1765,.437,603,1231,.490,169,534,.316,421,597,.705,374,741,1115,423,200,137,485,552,2134,59.3,1378.0,2012.0
vermont,36.0,7274.0,848,1914,.443,657,1353,.486,191,561,.340,528,714,.739,401,765,1166,475,221,86,445,627,2415,67.1,1436.0,2012.0
baylor,38.0,7626.0,1004,2148,.467,745,1472,.506,259,676,.383,572,759,.754,470,810,1280,570,286,178,522,674,2839,74.7,1124.0,2012.0
colorado,36.0,7225.0,835,1874,.446,636,1302,.488,199,572,.348,560,810,.691,351,841,1192,422,210,117,468,614,2429,67.5,1160.0,2012.0
gonzaga,33.0,6626.0,823,1740,.473,608,1173,.518,215,567,.379,575,803,.716,359,736,1095,455,223,105,433,514,2436,73.8,1211.0,2012.0
indiana,36.0,7200.0,949,1928,.492,720,1397,.515,229,531,.431,655,858,.763,383,747,1130,487,233,115,463,632,2782,77.3,1231.0,2012.0
iowa-state,34.0,6800.0,847,1888,.449,554,1102,.503,293,786,.373,503,731,.688,371,802,1173,484,196,96,419,547,2490,73.2,1235.0,2012.0
kansas-state,33.0,6675.0,812,1849,.439,629,1303,.483,183,546,.335,536,799,.671,471,658,1129,468,200,156,474,662,2343,71.0,1243.0,2012.0
kentucky,40.0,8001.0,1096,2248,.488,871,1653,.527,225,595,.378,678,938,.723,472,973,1445,531,242,344,445,593,3095,77.4,1246.0,2012.0
louisville,40.0,8100.0,963,2281,.422,730,1548,.472,233,733,.318,568,826,.688,518,905,1423,532,353,193,562,706,2727,68.2,1257.0,2012.0
marquette,35.0,7000.0,919,2033,.452,718,1437,.500,201,596,.337,599,831,.721,414,735,1149,580,304,122,461,620,2638,75.4,1266.0,2012.0
murray-state,33.0,6650.0,811,1732,.468,572,1128,.507,239,604,.396,551,761,.724,360,659,1019,418,276,139,458,592,2412,73.1,1293.0,2012.0
new-mexico,35.0,7025.0,876,1898,.462,612,1199,.510,264,699,.378,529,748,.707,395,821,1216,573,240,117,467,609,2545,72.7,1307.0,2012.0
ohio-state,39.0,7800.0,1057,2219,.476,858,1623,.529,199,596,.334,600,846,.709,447,898,1345,568,281,125,449,630,2913,74.7,1326.0,2012.0
syracuse,37.0,7425.0,1006,2156,.467,773,1488,.519,233,668,.349,495,709,.698,459,722,1181,564,338,255,389,574,2742,74.1,1393.0,2012.0
virginia-commonwealth,36.0,7250.0,837,2040,.410,570,1240,.460,267,800,.334,507,740,.685,439,676,1115,433,379,131,411,646,2448,68.0,1433.0,2012.0
vanderbilt,36.0,7276.0,885,1921,.461,578,1129,.512,307,792,.388,538,770,.699,361,764,1125,458,214,144,465,580,2615,72.6,1435.0,2012.0
wisconsin,36.0,7251.0,797,1875,.425,512,1100,.465,285,775,.368,425,575,.739,349,763,1112,428,181,126,320,512,2304,64.0,1458.0,2012.0
cincinnati,37.0,7501.0,924,2194,.421,664,1431,.464,260,763,.341,414,643,.644,489,736,1225,479,298,170,403,570,2522,68.2,1153.0,2012.0
creighton,35.0,7050.0,975,1935,.504,688,1258,.547,287,677,.424,535,737,.726,330,833,1163,616,169,82,421,592,2772,79.2,1166.0,2012.0
florida,37.0,7475.0,976,2106,.463,619,1167,.530,357,939,.380,499,700,.713,416,764,1180,551,233,124,410,575,2808,75.9,1196.0,2012.0
florida-state,35.0,7099.0,877,1923,.456,661,1312,.504,216,611,.354,473,669,.707,398,771,1169,427,265,213,550,653,2443,69.8,1199.0,2012.0
georgetown,33.0,6699.0,811,1743,.465,625,1207,.518,186,536,.347,470,673,.698,367,741,1108,451,200,156,417,578,2278,69.0,1207.0,2012.0
kansas,39.0,7826.0,1023,2169,.472,801,1526,.525,222,643,.345,597,863,.692,449,919,1368,587,285,222,506,678,2867,73.5,1242.0,2012.0
lehigh,35.0,7050.0,902,2030,.444,648,1304,.497,254,726,.350,590,768,.768,386,718,1104,456,269,106,391,629,2648,75.7,1250.0,2012.0
michigan-state,37.0,7424.0,960,2012,.477,760,1457,.522,200,555,.360,531,759,.700,420,882,1302,566,265,157,474,650,2651,71.6,1277.0,2012.0
north-carolina-state,37.0,7425.0,977,2134,.458,779,1577,.494,198,557,.355,545,774,.704,456,825,1281,577,249,150,470,623,2697,72.9,1301.0,2012.0
norfolk-state,36.0,7275.0,870,1977,.440,672,1342,.501,198,635,.312,544,829,.656,421,765,1186,431,240,169,539,702,2482,68.9,1313.0,2012.0
north-carolina,38.0,7626.0,1134,2473,.459,940,1893,.497,194,580,.334,629,922,.682,570,1022,1592,659,259,219,447,551,3091,81.3,1314.0,2012.0
ohio,37.0,7450.0,901,2107,.428,623,1298,.480,278,809,.344,517,749,.690,451,685,1136,488,347,103,481,723,2597,70.2,1325.0,2012.0
purdue,35.0,7000.0,889,2019,.440,605,1266,.478,284,753,.377,452,689,.656,391,648,1039,470,226,110,306,620,2514,71.8,1345.0,2012.0
saint-louis,34.0,6825.0,814,1813,.449,576,1150,.501,238,663,.359,470,653,.720,346,648,994,459,236,99,382,569,2336,68.7,1387.0,2012.0
xavier,36.0,7274.0,899,1986,.453,723,1485,.487,176,501,.351,569,819,.695,378,805,1183,471,216,135,448,665,2543,70.6,1462.0,2012.0
iona,33.0,6676.0,1021,2033,.502,767,1377,.557,254,656,.387,440,617,.713,353,689,1042,638,241,71,414,559,2736,82.9,1233.0,2012.0
mississippi-valley-state,34.0,6875.0,812,2025,.401,560,1248,.449,252,777,.324,456,708,.644,460,696,1156,451,300,87,511,698,2332,68.6,1290.0,2012.0
california,34.0,6800.0,893,1878,.476,737,1448,.509,156,430,.363,477,641,.744,341,754,1095,540,159,106,411,489,2419,71.1,1143.0,2012.0
lamar,35.0,7024.0,902,2087,.432,749,1633,.459,153,454,.337,616,855,.720,497,791,1288,448,283,154,418,604,2573,73.5,1249.0,2012.0
south-dakota-state,35.0,7075.0,918,1963,.468,634,1235,.513,284,728,.390,569,783,.727,363,715,1078,500,236,65,370,567,2689,76.8,1355.0,2012.0
nevada-las-vegas,35.0,7125.0,942,2062,.457,651,1263,.515,291,799,.364,496,734,.676,408,819,1227,616,299,169,466,604,2671,76.3,1424.0,2012.0
west-virginia,33.0,6775.0,838,1914,.438,664,1331,.499,174,583,.298,496,739,.671,493,642,1135,477,210,85,422,555,2346,71.1,1452.0,2012.0
new-mexico-state,36.0,7225.0,970,2045,.474,805,1540,.523,165,505,.327,707,1058,.668,518,834,1352,498,244,154,533,630,2812,78.1,1308.0,2012.0
connecticut,34.0,6875.0,858,1900,.452,673,1343,.501,185,557,.332,435,657,.662,415,736,1151,457,199,233,418,492,2336,68.7,1163.0,2012.0
southern-mississippi,34.0,6975.0,819,1975,.415,604,1374,.440,215,601,.358,573,779,.736,471,662,1133,374,205,98,377,651,2426,71.4,1379.0,2012.0
davidson,33.0,6650.0,879,1969,.446,624,1209,.516,255,760,.336,558,731,.763,415,752,1167,455,184,116,388,673,2571,77.9,1172.0,2012.0
colorado-state,32.0,6475.0,764,1621,.471,575,1148,.501,189,473,.400,526,685,.768,266,673,939,389,172,60,408,606,2243,70.1,1161.0,2012.0
long-beach-state,34.0,6850.0,880,1880,.468,659,1262,.522,221,618,.358,529,790,.670,391,750,1141,476,242,92,440,527,2510,73.8,1253.0,2012.0
loyola-md,33.0,6600.0,755,1775,.425,591,1291,.458,164,484,.339,548,762,.719,430,614,1044,393,255,147,443,628,2222,67.3,1259.0,2012.0
north-carolina-asheville,34.0,6824.0,920,1907,.482,697,1278,.545,223,629,.355,682,893,.764,377,716,1093,566,283,88,456,612,2745,80.7,1421.0,2012.0
wichita-state,33.0,6700.0,912,1892,.482,682,1272,.536,230,620,.371,491,656,.748,359,798,1157,485,209,130,403,553,2545,77.1,1455.0,2012.0
harvard,31.0,6225.0,695,1490,.466,510,972,.525,185,518,.357,458,613,.747,262,661,923,401,184,137,379,473,2033,65.6,1217.0,2012.0
montana,32.0,6425.0,781,1689,.462,586,1165,.503,195,524,.372,482,672,.717,286,663,949,436,229,115,401,585,2239,70.0,1285.0,2012.0
texas,34.0,6851.0,836,1927,.434,639,1326,.482,197,601,.328,601,820,.733,453,665,1118,419,231,125,426,659,2470,72.6,1400.0,2012.0
alabama,33.0,6649.0,778,1722,.452,642,1252,.513,136,470,.289,443,623,.711,352,714,1066,402,239,137,423,607,2135,64.7,1104.0,2012.0
virginia,32.0,6425.0,721,1576,.457,566,1107,.511,155,469,.330,403,558,.722,253,691,944,394,207,88,367,506,2000,62.5,1438.0,2012.0
st-bonaventure,32.0,6476.0,770,1687,.456,596,1183,.504,174,504,.345,540,710,.761,352,686,1038,444,186,133,439,592,2254,70.4,1382.0,2012.0
belmont,35.0,7049.0,975,2026,.481,666,1209,.551,309,817,.378,572,779,.734,401,750,1151,606,255,78,430,631,2831,80.9,1125.0,2012.0
detroit-mercy,36.0,7225.0,903,2008,.450,738,1455,.507,165,553,.298,626,857,.730,434,690,1124,463,272,165,450,684,2597,72.1,1178.0,2012.0
duke,34.0,6850.0,874,1915,.456,600,1176,.510,274,739,.371,606,864,.701,406,746,1152,423,210,136,415,626,2628,77.3,1181.0,2012.0
long-island-university,34.0,6825.0,920,1940,.474,695,1334,.521,225,606,.371,704,965,.730,396,771,1167,500,206,113,546,531,2769,81.4,1254.0,2012.0
san-diego-state,34.0,6900.0,863,1903,.453,666,1325,.503,197,578,.341,493,703,.701,360,793,1153,417,189,79,426,543,2416,71.1,1361.0,2012.0
missouri,35.0,7025.0,981,1945,.504,688,1208,.570,293,737,.398,559,730,.766,319,706,1025,566,285,97,358,499,2814,80.4,1281.0,2012.0
michigan,34.0,6875.0,808,1777,.455,532,989,.538,276,788,.350,363,503,.722,291,676,967,431,168,72,370,530,2255,66.3,1276.0,2012.0
saint-marys-ca,33.0,6625.0,857,1811,.473,612,1098,.557,245,713,.344,508,697,.729,378,774,1152,520,227,102,383,527,2467,74.8,1388.0,2012.0
temple,32.0,6525.0,861,1836,.469,633,1262,.502,228,574,.397,451,627,.719,333,686,1019,493,230,134,401,567,2401,75.0,1396.0,2012.0
memphis,35.0,7075.0,933,1899,.491,748,1388,.539,185,511,.362,563,785,.717,332,761,1093,505,278,196,444,665,2614,74.7,1272.0,2012.0
notre-dame,34.0,6900.0,781,1800,.434,560,1135,.493,221,665,.332,474,673,.704,345,705,1050,497,177,114,342,470,2257,66.4,1323.0,2012.0
north-carolina-at,37.0,7425.0,776,1927,.403,561,1220,.460,215,707,.304,532,809,.658,387,779,1166,405,261,165,564,716,2299,62.1,1299.0,2013.0
saint-marys-ca,35.0,7026.0,910,1939,.469,637,1211,.526,273,728,.375,517,713,.725,422,777,1199,502,214,98,416,612,2610,74.6,1388.0,2013.0
james-madison,36.0,7250.0,818,1941,.421,607,1313,.462,211,628,.336,499,714,.699,365,699,1064,423,272,166,401,620,2346,65.2,1241.0,2013.0
la-salle,34.0,6848.0,871,1931,.451,609,1236,.493,262,695,.377,446,605,.737,332,626,958,481,263,119,390,520,2450,72.1,1247.0,2013.0
arizona,35.0,7026.0,880,1933,.455,611,1208,.506,269,725,.371,541,722,.749,393,779,1172,476,234,134,458,584,2570,73.4,1112.0,2013.0
butler,36.0,7226.0,869,1931,.450,630,1243,.507,239,688,.347,518,744,.696,419,794,1213,465,206,94,474,644,2495,69.3,1139.0,2013.0
california,33.0,6624.0,833,1875,.444,699,1432,.488,134,443,.302,418,585,.715,361,773,1134,468,192,154,417,549,2218,67.2,1143.0,2013.0
colorado-state,35.0,7024.0,881,1961,.449,701,1429,.491,180,532,.338,611,855,.715,493,804,1297,445,162,74,389,600,2553,72.9,1161.0,2013.0
gonzaga,35.0,7000.0,961,1934,.497,735,1325,.555,226,609,.371,548,777,.705,409,786,1195,530,277,96,393,551,2696,77.0,1211.0,2013.0
harvard,30.0,6077.0,677,1425,.475,486,945,.514,191,480,.398,504,697,.723,219,577,796,392,218,126,399,457,2049,68.3,1217.0,2013.0
louisville,40.0,8125.0,1048,2300,.456,818,1609,.508,230,691,.333,652,920,.709,531,854,1385,584,430,168,495,727,2978,74.5,1257.0,2013.0
marquette,35.0,7100.0,842,1844,.457,695,1347,.516,147,497,.296,551,755,.730,418,698,1116,483,231,123,471,590,2382,68.1,1266.0,2013.0
memphis,36.0,7251.0,976,2071,.471,756,1479,.511,220,592,.372,509,771,.660,438,805,1243,605,321,231,523,651,2681,74.5,1272.0,2013.0
michigan,39.0,7876.0,1093,2260,.484,797,1491,.535,296,769,.385,450,642,.701,416,830,1246,565,239,108,368,496,2932,75.2,1276.0,2013.0
michigan-state,36.0,7199.0,882,1921,.459,705,1398,.504,177,523,.338,507,710,.714,421,820,1241,474,289,140,489,579,2448,68.0,1277.0,2013.0
oregon,37.0,7526.0,944,2110,.447,752,1533,.491,192,577,.333,570,809,.705,451,834,1285,484,314,146,555,651,2650,71.6,1332.0,2013.0
saint-louis,35.0,7050.0,808,1812,.446,598,1195,.500,210,617,.340,562,798,.704,306,726,1032,453,267,109,383,603,2388,68.2,1387.0,2013.0
syracuse,40.0,8050.0,1007,2293,.439,774,1597,.485,233,696,.335,569,843,.675,560,820,1380,562,360,248,495,637,2816,70.4,1393.0,2013.0
virginia-commonwealth,36.0,7252.0,1010,2243,.450,729,1443,.505,281,800,.351,469,669,.701,479,676,1155,521,422,109,407,708,2770,76.9,1433.0,2013.0
wichita-state,39.0,7800.0,954,2166,.440,695,1401,.496,259,765,.339,553,791,.699,512,843,1355,530,289,173,492,700,2720,69.7,1455.0,2013.0
creighton,36.0,7199.0,942,1882,.501,635,1140,.557,307,742,.414,489,644,.759,300,872,1172,609,174,92,443,588,2680,74.4,1166.0,2013.0
duke,36.0,7200.0,960,2033,.472,690,1357,.508,270,676,.399,588,796,.739,337,782,1119,515,232,135,383,645,2778,77.2,1181.0,2013.0
florida-gulf-coast,37.0,7475.0,976,2112,.462,729,1390,.524,247,722,.342,497,736,.675,412,814,1226,523,331,139,545,649,2696,72.9,1195.0,2013.0
florida,37.0,7400.0,960,2010,.478,660,1216,.543,300,794,.378,422,623,.677,381,798,1179,540,265,120,401,518,2642,71.4,1196.0,2013.0
illinois,36.0,7225.0,858,2084,.412,578,1211,.477,280,873,.321,469,646,.726,427,671,1098,365,245,142,411,648,2465,68.5,1228.0,2013.0
indiana,36.0,7253.0,951,1971,.482,694,1334,.520,257,637,.403,672,904,.743,439,831,1270,514,256,130,469,598,2831,78.6,1231.0,2013.0
iowa-state,35.0,7100.0,962,2111,.456,616,1187,.519,346,924,.374,509,696,.731,422,816,1238,560,223,97,460,593,2779,79.4,1235.0,2013.0
kansas,37.0,7525.0,985,2049,.481,769,1455,.529,216,594,.364,596,809,.737,399,955,1354,575,260,247,517,620,2782,75.2,1242.0,2013.0
miami-fl,36.0,7225.0,895,1968,.455,641,1267,.506,254,701,.362,465,680,.684,357,822,1179,408,223,159,377,525,2509,69.7,1274.0,2013.0
minnesota,34.0,6825.0,815,1838,.443,631,1292,.488,184,546,.337,523,764,.685,501,685,1186,503,253,187,467,605,2337,68.7,1278.0,2013.0
mississippi,36.0,7275.0,977,2230,.438,739,1495,.494,238,735,.324,587,866,.678,466,785,1251,450,297,185,395,606,2779,77.2,1279.0,2013.0
north-carolina,36.0,7225.0,1023,2321,.441,751,1598,.470,272,723,.376,442,655,.675,478,776,1254,616,303,117,433,539,2762,76.7,1314.0,2013.0
ohio-state,37.0,7426.0,928,2057,.451,701,1419,.494,227,638,.356,516,729,.708,378,841,1219,493,248,162,377,590,2599,70.2,1326.0,2013.0
san-diego-state,34.0,6824.0,839,1916,.438,637,1298,.491,202,618,.327,476,697,.683,376,768,1144,425,235,155,410,497,2356,69.3,1361.0,2013.0
temple,34.0,6800.0,851,1986,.428,608,1246,.488,243,740,.328,511,707,.723,381,676,1057,497,267,126,366,558,2456,72.2,1396.0,2013.0
liberty,36.0,7275.0,838,1954,.429,587,1285,.457,251,669,.375,562,770,.730,367,797,1164,443,197,105,478,685,2489,69.1,1251.0,2013.0
middle-tennessee,34.0,6850.0,848,1835,.462,667,1355,.492,181,480,.377,528,759,.696,407,740,1147,481,238,128,464,700,2405,70.7,1292.0,2013.0
long-island-university,34.0,6851.0,915,1909,.479,669,1262,.530,246,647,.380,601,870,.691,404,679,1083,515,232,117,486,597,2677,78.7,1254.0,2013.0
boise-state,32.0,6425.0,824,1790,.460,575,1153,.499,249,637,.391,446,597,.747,323,665,988,423,212,54,385,599,2343,73.2,1129.0,2013.0
belmont,33.0,6625.0,906,1844,.491,627,1115,.562,279,729,.383,442,604,.732,306,660,966,516,322,88,440,604,2533,76.8,1125.0,2013.0
bucknell,34.0,6800.0,818,1807,.453,661,1369,.483,157,438,.358,484,652,.742,308,834,1142,455,118,139,321,498,2277,67.0,1137.0,2013.0
nevada-las-vegas,35.0,7024.0,872,2002,.436,645,1313,.491,227,689,.329,525,747,.703,418,863,1281,562,253,203,487,593,2498,71.4,1424.0,2013.0
missouri,34.0,6850.0,924,2015,.459,709,1380,.514,215,635,.339,525,706,.744,454,812,1266,472,229,119,442,567,2588,76.1,1281.0,2013.0
southern,33.0,6599.0,761,1757,.433,535,1138,.470,226,619,.365,475,689,.689,288,747,1035,376,244,134,359,562,2223,67.4,1380.0,2013.0
new-mexico,35.0,7050.0,768,1815,.423,547,1186,.461,221,629,.351,598,829,.721,335,788,1123,505,220,134,402,542,2355,67.3,1307.0,2013.0
davidson,34.0,6825.0,837,1813,.462,581,1119,.519,256,694,.369,560,704,.795,306,742,1048,473,189,101,371,601,2490,73.2,1172.0,2013.0
south-dakota-state,35.0,7100.0,910,1938,.470,640,1244,.514,270,694,.389,478,627,.762,331,794,1125,506,175,78,365,492,2568,73.4,1355.0,2013.0
valparaiso,34.0,6824.0,823,1699,.484,570,1019,.559,253,680,.372,521,713,.731,303,705,1008,467,232,114,486,586,2420,71.2,1434.0,2013.0
oklahoma-state,33.0,6725.0,814,1854,.439,631,1274,.495,183,580,.316,560,751,.746,354,756,1110,398,248,155,411,598,2371,71.8,1329.0,2013.0
new-mexico-state,35.0,7050.0,832,1828,.455,695,1390,.500,137,438,.313,554,845,.656,429,806,1235,401,198,193,506,525,2355,67.3,1308.0,2013.0
montana,32.0,6525.0,760,1635,.465,541,1046,.517,219,589,.372,499,651,.767,248,657,905,405,187,100,391,543,2238,69.9,1285.0,2013.0
akron,33.0,6700.0,852,1874,.455,623,1185,.526,229,689,.332,436,678,.643,425,720,1145,485,231,189,458,577,2369,71.8,1103.0,2013.0
pittsburgh,33.0,6675.0,837,1775,.472,674,1308,.515,163,467,.349,445,666,.668,425,642,1067,537,218,131,364,575,2282,69.2,1338.0,2013.0
cincinnati,34.0,6875.0,791,1963,.403,561,1234,.455,230,729,.316,450,696,.647,488,731,1219,415,240,208,432,605,2262,66.5,1153.0,2013.0
albany-ny,35.0,7025.0,761,1748,.435,548,1173,.467,213,575,.370,516,700,.737,345,677,1022,394,192,71,468,564,2251,64.3,1107.0,2013.0
georgetown,32.0,6500.0,737,1627,.453,548,1091,.502,189,536,.353,407,599,.679,297,662,959,474,240,123,407,556,2070,64.7,1207.0,2013.0
northwestern-state,32.0,6400.0,919,2007,.458,730,1404,.520,189,603,.313,532,775,.686,435,698,1133,489,307,151,448,619,2559,80.0,1322.0,2013.0
colorado,33.0,6700.0,775,1788,.433,597,1271,.470,178,517,.344,502,732,.686,378,750,1128,328,230,105,439,525,2230,67.6,1160.0,2013.0
notre-dame,35.0,7199.0,892,1929,.462,664,1312,.506,228,617,.370,438,618,.709,387,759,1146,587,175,132,393,495,2450,70.0,1323.0,2013.0
western-kentucky,36.0,7225.0,837,1959,.427,611,1250,.489,226,709,.319,509,755,.674,441,763,1204,400,223,115,537,691,2409,66.9,1443.0,2013.0
kansas-state,35.0,7000.0,872,2002,.436,634,1344,.472,238,658,.362,432,631,.685,470,675,1145,557,247,129,403,631,2414,69.0,1243.0,2013.0
pacific,35.0,7026.0,824,1839,.448,599,1249,.480,225,590,.381,471,684,.689,333,704,1037,510,194,46,390,621,2344,67.0,1334.0,2013.0
ucla,35.0,7100.0,961,2131,.451,790,1617,.489,171,514,.333,511,706,.724,387,778,1165,559,283,127,391,526,2604,74.4,1417.0,2013.0
wisconsin,35.0,7100.0,823,1960,.420,564,1175,.480,259,785,.330,369,582,.634,401,801,1202,465,200,153,334,491,2274,65.0,1458.0,2013.0
villanova,34.0,6925.0,732,1760,.416,528,1143,.462,204,617,.331,639,889,.719,383,733,1116,413,263,114,533,651,2307,67.9,1437.0,2013.0
iona,34.0,6975.0,956,2106,.454,673,1335,.504,283,771,.367,538,689,.781,395,699,1094,523,222,101,421,582,2733,80.4,1233.0,2013.0
oklahoma,32.0,6450.0,803,1847,.435,644,1354,.476,159,493,.323,495,654,.757,377,689,1066,394,206,89,376,557,2260,70.6,1328.0,2013.0
north-carolina-state,35.0,7026.0,985,1987,.496,801,1516,.528,184,471,.391,554,813,.681,396,790,1186,511,227,147,433,544,2708,77.4,1301.0,2013.0
albany-ny,34.0,6876.0,765,1733,.441,602,1280,.470,163,453,.360,546,728,.750,343,832,1175,376,184,101,428,580,2239,65.9,1107.0,2014.0
north-carolina-state,36.0,7301.0,950,2060,.461,790,1535,.515,160,525,.305,501,762,.657,422,817,1239,466,173,149,375,670,2561,71.1,1301.0,2014.0
cal-poly,34.0,6800.0,754,1850,.408,536,1196,.448,218,654,.333,415,603,.688,377,719,1096,394,198,93,303,621,2141,63.0,1142.0,2014.0
tennessee,37.0,7450.0,927,2048,.453,722,1417,.510,205,631,.325,613,852,.719,501,923,1424,472,192,172,388,617,2672,72.2,1397.0,2014.0
connecticut,40.0,8050.0,971,2163,.449,684,1422,.481,287,741,.387,644,829,.777,387,1002,1389,488,281,230,457,719,2873,71.8,1163.0,2014.0
dayton,37.0,7450.0,935,2018,.463,692,1374,.504,243,644,.377,558,819,.681,414,875,1289,485,222,96,442,736,2671,72.2,1173.0,2014.0
florida,39.0,7799.0,945,2056,.460,690,1345,.513,255,711,.359,582,871,.668,437,948,1385,509,274,118,418,611,2727,69.9,1196.0,2014.0
harvard,32.0,6500.0,786,1691,.465,602,1213,.496,184,478,.385,587,811,.724,335,757,1092,449,243,155,365,566,2343,73.2,1217.0,2014.0
louisville,37.0,7400.0,1051,2232,.471,763,1449,.527,288,783,.368,608,920,.661,503,893,1396,568,370,173,391,723,2998,81.0,1257.0,2014.0
michigan,37.0,7450.0,945,1982,.477,626,1188,.527,319,794,.402,527,691,.763,316,844,1160,525,191,88,336,527,2736,73.9,1276.0,2014.0
michigan-state,38.0,7674.0,1024,2159,.474,717,1376,.521,307,783,.392,515,728,.707,395,1005,1400,637,259,174,430,721,2870,75.5,1277.0,2014.0
north-dakota-state,33.0,6625.0,888,1759,.505,712,1276,.558,176,483,.364,540,719,.751,307,774,1081,382,206,145,325,588,2492,75.5,1295.0,2014.0
oregon,34.0,6925.0,928,1977,.469,669,1311,.510,259,666,.389,668,865,.772,356,803,1159,492,263,113,389,725,2783,81.9,1332.0,2014.0
pittsburgh,36.0,7332.0,895,1944,.460,712,1422,.501,183,522,.351,613,861,.712,432,859,1291,563,254,107,373,620,2586,71.8,1338.0,2014.0
san-diego-state,36.0,7251.0,873,2009,.435,687,1490,.461,186,519,.358,598,902,.663,470,894,1364,356,274,183,355,600,2530,70.3,1361.0,2014.0
saint-louis,34.0,6875.0,829,1869,.444,639,1268,.504,190,601,.316,526,755,.697,345,886,1231,482,253,138,431,597,2374,69.8,1387.0,2014.0
syracuse,34.0,6850.0,819,1873,.437,652,1368,.477,167,505,.331,506,715,.708,446,754,1200,402,271,171,306,546,2311,68.0,1393.0,2014.0
texas,35.0,7025.0,905,2095,.432,727,1550,.469,178,545,.327,610,909,.671,528,921,1449,452,199,206,426,669,2598,74.2,1400.0,2014.0
villanova,34.0,6925.0,870,1907,.456,566,1052,.538,304,855,.356,607,848,.716,379,884,1263,523,236,141,406,672,2651,78.0,1437.0,2014.0
wisconsin,38.0,7625.0,927,2019,.459,630,1229,.513,297,790,.376,642,861,.746,337,929,1266,468,183,127,307,574,2793,73.5,1458.0,2014.0
arizona,38.0,7701.0,996,2123,.469,792,1562,.507,204,561,.364,573,870,.659,465,984,1449,574,223,173,387,630,2769,72.9,1112.0,2014.0
baylor,38.0,7698.0,959,2108,.455,679,1383,.491,280,725,.386,645,949,.680,525,931,1456,563,197,202,440,648,2843,74.8,1124.0,2014.0
creighton,35.0,7000.0,957,1927,.497,601,1068,.563,356,859,.414,486,654,.743,293,899,1192,614,139,49,342,618,2756,78.7,1166.0,2014.0
gonzaga,36.0,7105.0,972,1963,.495,717,1320,.543,255,643,.397,562,793,.709,343,948,1291,525,235,142,419,659,2761,76.7,1211.0,2014.0
iowa-state,36.0,7324.0,1062,2239,.474,761,1399,.544,301,840,.358,564,814,.693,375,1012,1387,663,214,106,380,623,2989,83.0,1235.0,2014.0
kansas,35.0,7048.0,955,1937,.493,766,1381,.555,189,556,.340,665,935,.711,416,920,1336,523,204,196,463,732,2764,79.0,1242.0,2014.0
kentucky,40.0,8074.0,1004,2213,.454,801,1602,.500,203,611,.332,781,1146,.682,562,1045,1607,446,189,236,469,732,2992,74.8,1246.0,2014.0
memphis,34.0,6850.0,958,2009,.477,776,1457,.533,182,552,.330,516,801,.644,427,841,1268,591,294,159,449,612,2614,76.9,1272.0,2014.0
mercer,36.0,7462.0,982,2061,.476,692,1305,.530,290,756,.384,582,791,.736,407,931,1338,586,211,147,420,665,2836,78.8,1273.0,2014.0
north-carolina,34.0,6851.0,953,2057,.463,807,1623,.497,146,434,.336,552,882,.626,483,867,1350,523,249,161,406,690,2604,76.6,1314.0,2014.0
stephen-f-austin,35.0,7050.0,922,1992,.463,674,1274,.529,248,718,.345,569,800,.711,451,735,1186,574,257,104,393,730,2661,76.0,1372.0,2014.0
stanford,36.0,7226.0,896,1950,.459,688,1379,.499,208,571,.364,616,877,.702,347,910,1257,415,191,154,409,655,2616,72.7,1390.0,2014.0
ucla,37.0,7450.0,1073,2196,.489,844,1593,.530,229,603,.380,628,839,.749,368,940,1308,636,341,111,379,652,3003,81.2,1417.0,2014.0
virginia,37.0,7428.0,855,1884,.454,649,1325,.490,206,559,.369,533,792,.673,379,933,1312,484,193,150,362,594,2449,66.2,1438.0,2014.0
wichita-state,36.0,7223.0,896,1942,.461,646,1229,.526,250,713,.351,664,916,.725,419,962,1381,491,247,184,374,611,2706,75.2,1455.0,2014.0
mount-st-marys,33.0,6650.0,843,1923,.438,547,1089,.502,296,834,.355,522,706,.739,328,725,1053,389,232,99,388,616,2504,75.9,1291.0,2014.0
xavier,34.0,6850.0,869,1850,.470,695,1350,.515,174,500,.348,530,770,.688,379,834,1213,497,196,97,421,674,2442,71.8,1462.0,2014.0
texas-southern,34.0,6900.0,857,1854,.462,640,1251,.512,217,603,.360,653,910,.718,386,860,1246,476,155,124,454,561,2584,76.0,1411.0,2014.0
iowa,33.0,6693.0,919,1984,.463,728,1438,.506,191,546,.350,660,898,.735,447,885,1332,532,234,164,371,603,2689,81.5,1234.0,2014.0
saint-josephs,34.0,6825.0,840,1789,.470,590,1129,.523,250,660,.379,503,780,.645,319,899,1218,476,151,154,409,544,2433,71.6,1386.0,2014.0
ohio-state,35.0,7049.0,843,1875,.450,643,1258,.511,200,617,.324,546,793,.689,346,841,1187,421,270,157,394,577,2432,69.5,1326.0,2014.0
cincinnati,34.0,6801.0,805,1893,.425,609,1308,.466,196,585,.335,519,733,.708,457,767,1224,425,268,188,377,596,2325,68.4,1153.0,2014.0
manhattan,33.0,6749.0,828,1837,.451,620,1273,.487,208,564,.369,676,1019,.663,415,819,1234,433,273,200,468,799,2540,77.0,1264.0,2014.0
wofford,33.0,6626.0,808,1804,.448,612,1260,.486,196,544,.360,393,592,.664,352,738,1090,423,205,54,351,578,2205,66.8,1459.0,2014.0
delaware,35.0,7027.0,936,2108,.444,684,1381,.495,252,727,.347,658,925,.711,385,879,1264,377,208,123,334,660,2782,79.5,1174.0,2014.0
oklahoma,33.0,6676.0,909,2034,.447,624,1282,.487,285,752,.379,601,802,.749,398,844,1242,483,224,108,376,625,2704,81.9,1328.0,2014.0
brigham-young,35.0,7123.0,1012,2186,.463,835,1687,.495,177,499,.355,730,1055,.692,463,969,1432,544,251,103,395,690,2931,83.7,1140.0,2014.0
colorado,35.0,7075.0,814,1871,.435,633,1302,.486,181,569,.318,648,903,.718,401,904,1305,397,207,115,466,576,2457,70.2,1160.0,2014.0
new-mexico-state,36.0,7275.0,936,1918,.488,742,1395,.532,194,523,.371,705,1027,.686,428,918,1346,474,169,224,457,614,2771,77.0,1308.0,2014.0
western-michigan,33.0,6701.0,779,1684,.463,584,1091,.535,195,593,.329,620,856,.724,323,820,1143,376,194,111,464,602,2373,71.9,1444.0,2014.0
arizona-state,33.0,6725.0,836,1852,.451,568,1164,.488,268,688,.390,546,787,.694,281,891,1172,471,167,182,377,635,2486,75.3,1113.0,2014.0
milwaukee,35.0,7076.0,808,1888,.428,563,1134,.496,245,754,.325,604,823,.734,343,839,1182,476,200,85,469,630,2465,70.4,1454.0,2014.0
american,33.0,6626.0,748,1527,.490,541,981,.551,207,546,.379,378,535,.707,232,754,986,492,198,110,464,567,2081,63.1,1110.0,2014.0
weber-state,31.0,6300.0,732,1541,.475,510,975,.523,222,566,.392,568,767,.741,265,800,1065,407,131,123,382,558,2254,72.7,1451.0,2014.0
nebraska,32.0,6400.0,719,1684,.427,531,1120,.474,188,564,.333,511,713,.717,278,781,1059,304,222,99,349,660,2137,66.8,1304.0,2014.0
louisiana-lafayette,35.0,7149.0,988,2127,.465,742,1457,.509,246,670,.367,613,913,.671,464,865,1329,472,250,144,459,734,2835,81.0,1418.0,2014.0
oklahoma-state,34.0,6954.0,898,1941,.463,659,1285,.513,239,656,.364,693,964,.719,332,871,1203,463,260,160,356,680,2728,80.2,1329.0,2014.0
north-carolina-central,34.0,6901.0,847,1832,.462,663,1287,.515,184,545,.338,635,872,.728,403,794,1197,500,262,137,389,660,2513,73.9,1300.0,2014.0
eastern-kentucky,34.0,6824.0,881,1810,.487,566,1003,.564,315,807,.390,600,798,.752,243,641,884,498,299,67,359,707,2677,78.7,1184.0,2014.0
kansas-state,33.0,6674.0,798,1840,.434,600,1242,.483,198,598,.331,486,741,.656,406,774,1180,503,205,98,404,714,2280,69.1,1243.0,2014.0
george-washington,33.0,6622.0,839,1812,.463,652,1298,.502,187,514,.364,550,845,.651,394,835,1229,461,235,135,428,595,2415,73.2,1203.0,2014.0
duke,35.0,7025.0,929,2020,.460,613,1219,.503,316,801,.395,571,783,.729,410,797,1207,509,244,105,328,681,2745,78.4,1181.0,2014.0
providence,35.0,7250.0,849,1984,.428,631,1356,.465,218,628,.347,650,831,.782,432,846,1278,476,194,173,406,603,2566,73.3,1344.0,2014.0
virginia-commonwealth,35.0,7100.0,922,2196,.420,662,1452,.456,260,744,.349,520,772,.674,479,838,1317,459,391,150,423,686,2624,75.0,1433.0,2014.0
new-mexico,34.0,6899.0,847,1851,.458,650,1258,.517,197,593,.332,625,863,.724,360,936,1296,522,162,172,361,577,2516,74.0,1307.0,2014.0
massachusetts,33.0,6625.0,900,1962,.459,723,1450,.499,177,512,.346,525,769,.683,404,863,1267,499,226,178,446,649,2502,75.8,1269.0,2014.0
tulsa,34.0,6850.0,835,1899,.440,638,1296,.492,197,603,.327,604,894,.676,368,863,1231,427,232,127,394,725,2471,72.7,1409.0,2014.0
coastal-carolina,34.0,6873.0,861,1969,.437,649,1341,.484,212,628,.338,524,758,.691,434,902,1336,362,216,96,473,668,2458,72.3,1157.0,2014.0
hampton,35.0,7025.0,796,1959,.406,602,1321,.456,194,638,.304,560,859,.652,416,876,1292,372,235,141,494,752,2346,67.0,1214.0,2015.0
mississippi,34.0,6845.0,848,2003,.423,628,1341,.468,220,662,.332,559,723,.773,430,854,1284,450,225,128,378,668,2475,72.8,1279.0,2015.0
dayton,36.0,7225.0,810,1755,.462,571,1085,.526,239,670,.357,580,846,.686,255,866,1121,490,250,91,415,573,2439,67.8,1173.0,2015.0
robert-morris,35.0,7050.0,854,1926,.443,633,1336,.474,221,590,.375,485,684,.709,367,795,1162,428,300,100,467,650,2414,69.0,1352.0,2015.0
arizona,38.0,7625.0,1009,2068,.488,816,1532,.533,193,536,.360,700,974,.719,411,988,1399,528,275,131,419,681,2911,76.6,1112.0,2015.0
arkansas,36.0,7252.0,978,2196,.445,740,1515,.488,238,681,.349,593,819,.724,470,820,1290,579,277,168,430,684,2787,77.4,1116.0,2015.0
butler,34.0,6900.0,814,1882,.433,622,1342,.463,192,540,.356,526,767,.686,408,831,1239,387,217,103,376,592,2346,69.0,1139.0,2015.0
cincinnati,34.0,6899.0,761,1705,.446,594,1198,.496,167,507,.329,424,633,.670,383,795,1178,394,222,185,432,507,2113,62.1,1153.0,2015.0
georgetown,33.0,6699.0,799,1753,.456,598,1184,.505,201,569,.353,541,769,.704,367,785,1152,427,251,156,415,668,2340,70.9,1207.0,2015.0
georgia-state,35.0,7075.0,902,1878,.480,728,1356,.537,174,522,.333,521,719,.725,322,794,1116,479,321,143,366,642,2499,71.4,1209.0,2015.0
kentucky,39.0,7873.0,1006,2150,.468,803,1568,.512,203,582,.349,685,943,.726,491,991,1482,553,253,268,408,665,2900,74.4,1246.0,2015.0
north-carolina-state,36.0,7252.0,895,2054,.436,659,1393,.473,236,661,.357,499,727,.686,435,934,1369,415,138,184,375,637,2525,70.1,1301.0,2015.0
north-carolina,38.0,7650.0,1099,2309,.476,915,1795,.510,184,514,.358,571,814,.701,526,1015,1541,661,251,160,481,738,2953,77.7,1314.0,2015.0
notre-dame,38.0,7725.0,1050,2061,.509,748,1286,.582,302,775,.390,561,756,.742,313,918,1231,576,256,138,357,540,2963,78.0,1323.0,2015.0
ohio-state,35.0,7050.0,964,1995,.483,728,1358,.536,236,637,.370,471,693,.680,387,854,1241,534,266,178,396,563,2635,75.3,1326.0,2015.0
alabama-birmingham,36.0,7400.0,873,2042,.428,671,1435,.468,202,607,.333,528,715,.738,434,888,1322,516,237,184,482,630,2476,68.8,1412.0,2015.0
ucla,36.0,7250.0,930,2099,.443,707,1493,.474,223,606,.368,507,750,.676,440,927,1367,498,238,139,430,645,2590,71.9,1417.0,2015.0
utah,35.0,7024.0,849,1760,.482,585,1106,.529,264,654,.404,534,760,.703,322,882,1204,489,208,175,407,581,2496,71.3,1428.0,2015.0
villanova,36.0,7250.0,916,1951,.470,590,1114,.530,326,837,.389,596,815,.731,371,864,1235,570,278,146,382,596,2754,76.5,1437.0,2015.0
xavier,37.0,7525.0,956,2011,.475,722,1345,.537,234,666,.351,566,775,.730,364,918,1282,596,223,106,447,661,2712,73.3,1462.0,2015.0
duke,39.0,7850.0,1099,2191,.502,816,1459,.559,283,732,.387,610,873,.699,445,991,1436,588,278,149,421,607,3091,79.3,1181.0,2015.0
gonzaga,38.0,7625.0,1084,2083,.520,820,1423,.576,264,660,.400,557,806,.691,391,1050,1441,620,226,126,397,637,2989,78.7,1211.0,2015.0
iowa,34.0,6850.0,821,1905,.431,629,1329,.473,192,576,.333,538,723,.744,422,852,1274,482,218,158,377,536,2372,69.8,1234.0,2015.0
kansas,36.0,7225.0,869,1976,.440,656,1414,.464,213,562,.379,610,842,.724,426,938,1364,475,237,175,463,639,2561,71.1,1242.0,2015.0
louisville,36.0,7249.0,878,2048,.429,680,1404,.484,198,644,.307,529,792,.668,454,897,1351,419,283,192,408,623,2483,69.0,1257.0,2015.0
maryland,35.0,7050.0,781,1777,.440,523,1090,.480,258,687,.376,597,790,.756,314,909,1223,376,169,151,431,584,2417,69.1,1268.0,2015.0
michigan-state,39.0,8025.0,1014,2181,.465,720,1418,.508,294,763,.385,451,714,.632,436,1022,1458,646,203,176,441,738,2773,71.1,1277.0,2015.0
northern-iowa,35.0,7101.0,776,1618,.480,519,973,.533,257,645,.398,472,644,.733,255,816,1071,413,207,84,363,508,2281,65.2,1320.0,2015.0
oklahoma,35.0,7050.0,885,2035,.435,649,1347,.482,236,688,.343,495,668,.741,389,943,1332,430,237,174,419,570,2501,71.5,1328.0,2015.0
oregon,36.0,7300.0,992,2143,.463,729,1417,.514,263,726,.362,466,613,.760,372,926,1298,508,207,157,421,655,2713,75.4,1332.0,2015.0
san-diego-state,36.0,7276.0,800,1916,.418,611,1325,.461,189,591,.320,437,694,.630,439,831,1270,377,247,179,410,506,2226,61.8,1361.0,2015.0
virginia,34.0,6850.0,804,1758,.457,634,1275,.497,170,483,.352,446,614,.726,358,874,1232,430,186,143,316,484,2224,65.4,1438.0,2015.0
west-virginia,35.0,7050.0,872,2138,.408,645,1419,.455,227,719,.316,571,863,.662,575,697,1272,494,376,96,453,821,2542,72.6,1452.0,2015.0
wichita-state,35.0,7050.0,860,1933,.445,621,1263,.492,239,670,.357,501,715,.701,415,830,1245,476,250,134,327,587,2460,70.3,1455.0,2015.0
wisconsin,40.0,8050.0,1014,2115,.479,726,1325,.548,288,790,.365,584,765,.763,383,955,1338,504,174,127,296,501,2900,72.5,1458.0,2015.0
manhattan,33.0,6700.0,756,1748,.432,541,1108,.488,215,640,.336,573,829,.691,345,720,1065,460,264,92,481,758,2300,69.7,1264.0,2015.0
brigham-young,35.0,7100.0,976,2090,.467,676,1327,.509,300,763,.393,679,886,.766,421,928,1349,594,257,103,417,721,2931,83.7,1140.0,2015.0
boise-state,34.0,6925.0,831,1823,.456,534,1065,.501,297,758,.392,431,591,.729,298,821,1119,409,206,79,348,582,2390,70.3,1129.0,2015.0
north-florida,35.0,7000.0,897,1910,.470,580,1100,.527,317,810,.391,540,747,.723,339,880,1219,506,214,146,436,568,2651,75.7,1316.0,2015.0
texas-southern,35.0,7152.0,818,1840,.445,633,1266,.500,185,574,.322,569,861,.661,394,799,1193,375,214,109,454,609,2390,68.3,1411.0,2015.0
wofford,35.0,7000.0,818,1802,.454,596,1206,.494,222,596,.372,473,688,.688,324,815,1139,461,228,87,379,589,2331,66.6,1459.0,2015.0
texas,34.0,6875.0,796,1837,.433,584,1211,.482,212,626,.339,486,671,.724,422,929,1351,442,128,265,435,555,2290,67.4,1400.0,2015.0
purdue,34.0,6876.0,827,1840,.449,632,1243,.508,195,597,.327,524,767,.683,409,840,1249,505,185,177,444,642,2375,69.9,1345.0,2015.0
eastern-washington,35.0,7050.0,977,2045,.478,633,1185,.534,344,860,.400,522,719,.726,351,832,1183,454,219,167,376,624,2820,80.6,1186.0,2015.0
baylor,34.0,6850.0,813,1874,.434,577,1248,.462,236,626,.377,487,723,.674,497,836,1333,497,263,132,434,565,2349,69.1,1124.0,2015.0
louisiana-state,33.0,6750.0,892,1962,.455,703,1404,.501,189,558,.339,450,658,.684,401,893,1294,516,240,204,476,516,2423,73.4,1261.0,2015.0
harvard,30.0,6098.0,671,1548,.433,525,1136,.462,146,412,.354,438,609,.719,316,709,1025,384,213,135,349,472,1926,64.2,1217.0,2015.0
northeastern,35.0,7075.0,838,1725,.486,635,1199,.530,203,526,.386,518,713,.727,297,863,1160,500,183,129,483,496,2397,68.5,1318.0,2015.0
virginia-commonwealth,36.0,7375.0,896,2139,.419,603,1285,.469,293,854,.343,524,797,.657,444,833,1277,456,342,153,383,690,2609,72.5,1433.0,2015.0
iowa-state,34.0,6800.0,940,1973,.476,677,1247,.543,263,726,.362,502,721,.696,323,898,1221,546,218,133,375,527,2645,77.8,1235.0,2015.0
southern-methodist,34.0,6825.0,832,1750,.475,687,1350,.509,145,400,.363,541,770,.703,388,856,1244,524,237,146,426,551,2350,69.1,1374.0,2015.0
stephen-f-austin,34.0,6824.0,911,1870,.487,649,1178,.551,262,692,.379,588,799,.736,413,763,1176,596,259,120,476,734,2672,78.6,1372.0,2015.0
lafayette,33.0,6625.0,872,1799,.485,611,1159,.527,261,640,.408,421,549,.767,282,735,1017,514,181,83,366,515,2426,73.5,1248.0,2015.0
providence,34.0,6850.0,828,1889,.438,657,1343,.489,171,546,.313,543,768,.707,411,817,1228,474,242,155,407,628,2370,69.7,1344.0,2015.0
north-dakota-state,33.0,6675.0,743,1713,.434,513,1113,.461,230,600,.383,425,614,.692,274,824,1098,315,156,123,325,504,2141,64.9,1295.0,2015.0
davidson,32.0,6425.0,898,1924,.467,555,1047,.530,343,877,.391,390,553,.705,335,809,1144,547,171,93,303,601,2529,79.0,1172.0,2015.0
new-mexico-state,34.0,6850.0,808,1748,.462,643,1298,.495,165,450,.367,535,771,.694,428,771,1199,406,219,124,470,541,2316,68.1,1308.0,2015.0
california-irvine,34.0,6850.0,854,1851,.461,637,1293,.493,217,558,.389,370,541,.684,329,869,1198,480,194,168,396,578,2295,67.5,1414.0,2015.0
valparaiso,34.0,6826.0,837,1836,.456,601,1216,.494,236,620,.381,456,676,.675,397,879,1276,443,203,157,422,563,2366,69.6,1434.0,2015.0
georgia,33.0,6755.0,747,1730,.432,563,1192,.472,184,538,.342,572,826,.692,360,900,1260,411,183,151,420,608,2250,68.2,1208.0,2015.0
wyoming,35.0,7152.0,747,1619,.461,538,977,.551,209,642,.326,448,638,.702,216,831,1047,501,191,102,392,481,2151,61.5,1461.0,2015.0
albany-ny,33.0,6624.0,729,1666,.438,524,1094,.479,205,572,.358,493,650,.758,334,777,1111,349,187,53,381,544,2156,65.3,1107.0,2015.0
oklahoma-state,32.0,6450.0,733,1667,.440,507,1020,.497,226,647,.349,468,645,.726,287,752,1039,366,253,156,392,614,2160,67.5,1329.0,2015.0
st-johns-ny,33.0,6625.0,835,1890,.442,637,1321,.482,198,569,.348,475,687,.691,336,828,1164,408,246,210,352,587,2343,71.0,1385.0,2015.0
belmont,33.0,6602.0,858,1803,.476,529,937,.565,329,866,.380,405,585,.692,307,786,1093,504,209,66,451,549,2450,74.2,1125.0,2015.0
buffalo,33.0,6600.0,837,1922,.435,638,1339,.476,199,583,.341,589,819,.719,420,840,1260,433,248,132,378,613,2462,74.6,1138.0,2015.0
indiana,34.0,6825.0,923,1989,.464,604,1203,.502,319,786,.406,468,651,.719,407,817,1224,473,170,108,392,606,2633,77.4,1231.0,2015.0
coastal-carolina,34.0,6798.0,836,1899,.440,608,1266,.480,228,633,.360,538,780,.690,447,891,1338,385,240,111,399,559,2438,71.7,1157.0,2015.0
florida-gulf-coast,35.0,7175.0,1008,2106,.479,822,1579,.521,186,527,.353,501,778,.644,417,1005,1422,483,230,141,438,674,2703,77.2,1195.0,2016.0
wichita-state,35.0,7050.0,867,2023,.429,617,1252,.493,250,771,.324,551,768,.717,408,897,1305,489,255,125,346,705,2535,72.4,1455.0,2016.0
holy-cross,35.0,7125.0,775,1879,.412,524,1110,.472,251,769,.326,466,678,.687,279,773,1052,480,219,86,386,585,2267,64.8,1221.0,2016.0
michigan,36.0,7225.0,947,2048,.462,605,1147,.527,342,901,.380,420,569,.738,290,862,1152,537,203,81,348,558,2656,73.8,1276.0,2016.0
arkansas-little-rock,35.0,7075.0,886,1958,.453,620,1265,.490,266,693,.384,449,616,.729,324,871,1195,451,230,106,355,640,2487,71.1,1114.0,2016.0
butler,33.0,6625.0,918,1969,.466,682,1368,.499,236,601,.393,566,774,.731,366,822,1188,468,227,107,335,646,2638,79.9,1139.0,2016.0
connecticut,36.0,7300.0,944,2078,.454,689,1379,.500,255,699,.365,488,615,.793,338,962,1300,489,210,182,385,657,2631,73.1,1163.0,2016.0
duke,36.0,7250.0,983,2136,.460,655,1285,.510,328,851,.385,626,866,.723,426,870,1296,478,226,154,354,603,2920,81.1,1181.0,2016.0
gonzaga,36.0,7225.0,1011,2081,.486,730,1343,.544,281,738,.381,537,708,.758,382,1044,1426,501,184,111,418,623,2840,78.9,1211.0,2016.0
indiana,35.0,7025.0,1021,2034,.502,676,1203,.562,345,831,.415,504,688,.733,414,874,1288,560,239,137,474,647,2891,82.6,1231.0,2016.0
iowa-state,35.0,7075.0,1087,2159,.503,794,1401,.567,293,758,.387,395,563,.702,304,940,1244,577,218,142,398,542,2862,81.8,1235.0,2016.0
kansas,38.0,7700.0,1092,2207,.495,788,1479,.533,304,728,.418,601,843,.713,402,1041,1443,604,253,158,478,719,3089,81.3,1242.0,2016.0
kentucky,36.0,7275.0,1028,2149,.478,784,1483,.529,244,666,.366,561,813,.690,462,933,1395,512,206,207,389,735,2861,79.5,1246.0,2016.0
miami-fl,35.0,7025.0,907,1895,.479,666,1252,.532,241,643,.375,578,772,.749,330,877,1207,438,215,127,383,581,2633,75.2,1274.0,2016.0
north-carolina,40.0,8000.0,1235,2560,.482,1011,1875,.539,224,685,.327,617,826,.747,568,1056,1624,708,269,177,431,718,3311,82.8,1314.0,2016.0
providence,35.0,7075.0,881,2093,.421,632,1317,.480,249,776,.321,566,781,.725,402,861,1263,550,229,123,397,591,2577,73.6,1344.0,2016.0
utah,36.0,7300.0,977,2000,.489,704,1254,.561,273,746,.366,551,764,.721,347,988,1335,557,199,149,451,549,2778,77.2,1428.0,2016.0
virginia,37.0,7425.0,964,1964,.491,740,1407,.526,224,557,.402,474,630,.752,323,866,1189,551,199,119,345,596,2626,71.0,1438.0,2016.0
yale,30.0,6025.0,795,1693,.470,605,1170,.517,190,523,.363,468,699,.670,407,801,1208,452,170,137,398,530,2248,74.9,1463.0,2016.0
hawaii,34.0,6825.0,893,1946,.459,656,1209,.543,237,737,.322,597,873,.684,362,908,1270,525,257,124,443,695,2620,77.1,1218.0,2016.0
iowa,33.0,6650.0,906,2027,.447,637,1308,.487,269,719,.374,480,669,.717,392,865,1257,523,223,156,339,538,2561,77.6,1234.0,2016.0
maryland,36.0,7225.0,943,1941,.486,676,1202,.562,267,739,.361,572,745,.768,319,969,1288,488,210,194,458,605,2725,75.7,1268.0,2016.0
middle-tennessee,35.0,7025.0,909,2025,.449,630,1309,.481,279,716,.390,442,718,.616,369,914,1283,455,215,123,419,700,2539,72.5,1292.0,2016.0
northern-iowa,36.0,7275.0,849,1864,.455,551,1068,.516,298,796,.374,479,633,.757,195,896,1091,429,204,94,357,560,2475,68.8,1320.0,2016.0
notre-dame,36.0,7225.0,972,2042,.476,710,1342,.529,262,700,.374,498,671,.742,381,884,1265,480,197,143,359,544,2704,75.1,1323.0,2016.0
oklahoma,37.0,7475.0,1018,2225,.458,636,1319,.482,382,906,.422,530,734,.722,407,1011,1418,537,247,188,484,630,2948,79.7,1328.0,2016.0
oregon,38.0,7625.0,1041,2230,.467,781,1472,.531,260,758,.343,648,906,.715,442,940,1382,517,275,221,431,675,2990,78.7,1332.0,2016.0
stephen-f-austin,34.0,6800.0,972,2032,.478,703,1291,.545,269,741,.363,515,701,.735,405,783,1188,635,310,122,411,700,2728,80.2,1372.0,2016.0
saint-josephs,36.0,7225.0,976,2153,.453,725,1386,.523,251,767,.327,577,806,.716,364,1014,1378,534,184,119,355,583,2780,77.2,1386.0,2016.0
syracuse,37.0,7475.0,884,2080,.425,569,1204,.473,315,876,.360,506,736,.688,445,874,1319,493,300,162,440,598,2589,70.0,1393.0,2016.0
texas-am,37.0,7500.0,991,2208,.449,710,1384,.513,281,824,.341,565,841,.672,477,984,1461,612,260,133,434,668,2828,76.4,1401.0,2016.0
virginia-commonwealth,36.0,7250.0,1010,2238,.451,748,1493,.501,262,745,.352,499,721,.692,447,900,1347,515,309,135,405,706,2781,77.3,1433.0,2016.0
villanova,40.0,8025.0,1086,2247,.483,739,1288,.574,347,959,.362,599,766,.782,351,1034,1385,637,282,136,440,681,3118,78.0,1437.0,2016.0
wisconsin,35.0,7050.0,816,1917,.426,587,1261,.466,229,656,.349,512,728,.703,398,830,1228,400,205,114,386,588,2373,67.8,1458.0,2016.0
xavier,34.0,6800.0,928,2054,.452,673,1352,.498,255,702,.363,626,857,.730,436,951,1387,548,246,101,429,678,2737,80.5,1462.0,2016.0
fairleigh-dickinson,33.0,6675.0,929,2029,.458,691,1372,.504,238,657,.362,462,663,.697,348,760,1108,472,250,87,423,720,2558,77.5,1192.0,2016.0
vanderbilt,33.0,6650.0,857,1879,.456,584,1165,.501,273,714,.382,519,747,.695,313,960,1273,487,139,182,386,632,2506,75.9,1435.0,2016.0
southern,35.0,7000.0,909,2046,.444,698,1436,.486,211,610,.346,505,754,.670,365,893,1258,381,258,123,391,680,2534,72.4,1380.0,2016.0
tulsa,32.0,6450.0,821,1849,.444,602,1178,.511,219,671,.326,495,731,.677,323,800,1123,435,216,88,346,563,2356,73.6,1409.0,2016.0
purdue,35.0,7075.0,960,2042,.470,692,1311,.528,268,731,.367,538,723,.744,407,1036,1443,615,147,165,419,607,2726,77.9,1345.0,2016.0
texas-tech,32.0,6475.0,785,1754,.448,600,1220,.492,185,534,.346,550,741,.742,326,760,1086,418,190,134,385,589,2305,72.0,1403.0,2016.0
colorado,34.0,6850.0,865,2029,.426,613,1382,.444,252,647,.389,594,808,.735,446,988,1434,461,177,167,454,638,2576,75.8,1160.0,2016.0
north-carolina-wilmington,33.0,6675.0,928,2039,.455,698,1362,.512,230,677,.340,534,760,.703,397,840,1237,438,246,143,374,793,2620,79.4,1423.0,2016.0
seton-hall,34.0,6825.0,892,1999,.446,686,1405,.488,206,594,.347,532,808,.658,438,917,1355,455,251,155,469,636,2522,74.2,1371.0,2016.0
chattanooga,35.0,7050.0,897,1963,.457,635,1234,.515,262,729,.359,596,811,.735,381,860,1241,504,272,165,437,596,2652,75.8,1151.0,2016.0
iona,33.0,6625.0,919,2011,.457,592,1127,.525,327,884,.370,463,651,.711,348,870,1218,551,248,135,422,642,2628,79.6,1233.0,2016.0
austin-peay,36.0,7300.0,945,2049,.461,722,1404,.514,223,645,.346,627,936,.670,422,904,1326,479,250,101,502,633,2740,76.1,1122.0,2016.0
stony-brook,33.0,6625.0,933,1992,.468,713,1394,.511,220,598,.368,429,637,.673,426,886,1312,541,204,150,379,523,2515,76.2,1392.0,2016.0
buffalo,35.0,7050.0,915,2096,.437,652,1320,.494,263,776,.339,616,867,.710,425,938,1363,441,240,124,475,748,2709,77.4,1138.0,2016.0
southern-california,34.0,6900.0,982,2138,.459,716,1450,.494,266,688,.387,507,750,.676,401,936,1337,504,215,181,415,590,2737,80.5,1425.0,2016.0
fresno-state,35.0,7100.0,926,2126,.436,707,1488,.475,219,638,.343,559,805,.694,409,884,1293,466,295,138,378,764,2630,75.1,1201.0,2016.0
hampton,32.0,6525.0,810,1967,.412,604,1289,.469,206,678,.304,537,815,.659,447,875,1322,381,169,117,440,649,2363,73.8,1214.0,2016.0
arizona,34.0,6950.0,946,1970,.480,725,1390,.522,221,580,.381,622,863,.721,394,974,1368,485,164,161,442,621,2735,80.4,1112.0,2016.0
baylor,34.0,6875.0,933,2003,.466,723,1431,.505,210,572,.367,545,752,.725,467,800,1267,603,269,135,432,660,2621,77.1,1124.0,2016.0
california,34.0,6875.0,890,1931,.461,654,1280,.511,236,651,.363,529,806,.656,386,963,1349,430,139,159,419,706,2545,74.9,1143.0,2016.0
temple,33.0,6725.0,822,2021,.407,567,1264,.449,255,757,.337,368,538,.684,371,854,1225,445,173,103,305,535,2267,68.7,1396.0,2016.0
south-dakota-state,34.0,6800.0,877,1950,.450,622,1235,.504,255,715,.357,582,783,.743,381,898,1279,381,169,84,399,670,2591,76.2,1355.0,2016.0
michigan-state,35.0,7050.0,1009,2078,.486,688,1339,.514,321,739,.434,454,623,.729,427,1027,1454,719,156,177,406,671,2793,79.8,1277.0,2016.0
texas,33.0,6650.0,814,1884,.432,582,1203,.484,232,681,.341,495,743,.666,363,776,1139,377,167,144,341,688,2355,71.4,1400.0,2016.0
cal-state-bakersfield,33.0,6650.0,875,1939,.451,696,1415,.492,179,524,.342,476,726,.656,414,849,1263,516,263,165,405,707,2405,72.9,1167.0,2016.0
west-virginia,35.0,7050.0,943,2102,.449,734,1459,.503,209,643,.325,654,972,.673,558,822,1380,510,343,93,498,819,2749,78.5,1452.0,2016.0
cincinnati,33.0,6775.0,851,1980,.430,599,1255,.477,252,725,.348,464,658,.705,441,850,1291,508,257,192,363,513,2418,73.3,1153.0,2016.0
dayton,33.0,6675.0,836,1836,.455,615,1193,.516,221,643,.344,500,749,.668,327,938,1265,480,196,145,427,626,2393,72.5,1173.0,2016.0
green-bay,36.0,7275.0,1048,2350,.446,793,1620,.490,255,730,.349,662,1007,.657,458,927,1385,501,358,166,441,724,3013,83.7,1453.0,2016.0
oregon-state,32.0,6400.0,811,1843,.440,593,1256,.472,218,587,.371,461,687,.671,337,765,1102,432,236,106,361,642,2301,71.9,1333.0,2016.0
north-carolina-asheville,34.0,6850.0,898,1973,.455,703,1370,.513,195,603,.323,561,808,.694,396,882,1278,422,312,112,444,587,2552,75.1,1421.0,2016.0
pittsburgh,33.0,6650.0,878,1919,.458,674,1330,.507,204,589,.346,516,686,.752,417,840,1257,547,162,121,384,581,2476,75.0,1338.0,2016.0
weber-state,35.0,7100.0,908,1885,.482,617,1100,.561,291,785,.371,555,821,.676,300,996,1296,477,175,119,462,611,2662,76.1,1451.0,2016.0
kansas-state,35.0,7025.0,869,1883,.461,622,1200,.518,247,683,.362,538,775,.694,330,802,1132,521,271,130,453,630,2523,72.1,1243.0,2017.0
mount-st-marys,36.0,7225.0,877,1977,.444,616,1247,.494,261,730,.358,431,640,.673,276,806,1082,403,222,142,472,640,2446,67.9,1291.0,2017.0
california-davis,36.0,7275.0,873,2008,.435,652,1373,.475,221,635,.348,558,828,.674,364,916,1280,461,202,118,513,688,2525,70.1,1413.0,2017.0
southern-california,36.0,7225.0,975,2139,.456,692,1357,.510,283,782,.362,583,787,.741,387,899,1286,550,252,190,398,571,2816,78.2,1425.0,2017.0
arizona,37.0,7400.0,977,2048,.477,733,1423,.515,244,625,.390,635,830,.765,380,978,1358,501,201,119,413,625,2833,76.6,1112.0,2017.0
butler,34.0,6850.0,906,1898,.477,645,1184,.545,261,714,.366,522,704,.741,287,804,1091,453,206,96,346,640,2595,76.3,1139.0,2017.0
florida,36.0,7275.0,953,2118,.450,675,1342,.503,278,776,.358,620,851,.729,416,915,1331,450,272,167,431,661,2804,77.9,1196.0,2017.0
florida-state,35.0,7000.0,1036,2146,.483,803,1475,.544,233,671,.347,568,824,.689,409,915,1324,511,259,180,415,684,2873,82.1,1199.0,2017.0
gonzaga,39.0,7800.0,1149,2280,.504,863,1531,.564,286,749,.382,638,890,.717,378,1209,1587,595,265,183,448,660,3222,82.6,1211.0,2017.0
iowa-state,35.0,7125.0,1031,2186,.472,687,1326,.518,344,860,.400,423,604,.700,318,901,1219,553,272,124,355,557,2829,80.8,1235.0,2017.0
middle-tennessee,36.0,7225.0,1014,2077,.488,786,1455,.540,228,622,.367,441,631,.699,355,918,1273,552,242,100,374,655,2697,74.9,1292.0,2017.0
northwestern,36.0,7200.0,913,2094,.436,657,1347,.488,256,747,.343,476,637,.747,386,918,1304,540,190,175,383,691,2558,71.1,1321.0,2017.0
notre-dame,36.0,7225.0,980,2139,.458,646,1270,.509,334,869,.384,489,611,.800,334,878,1212,566,255,134,341,533,2783,77.3,1323.0,2017.0
purdue,35.0,7075.0,980,2044,.479,665,1262,.527,315,782,.403,515,680,.757,344,978,1322,640,181,87,455,552,2790,79.7,1345.0,2017.0
saint-marys-ca,34.0,6800.0,892,1797,.496,599,1053,.569,293,744,.394,372,499,.745,324,881,1205,563,143,110,365,512,2449,72.0,1388.0,2017.0
villanova,36.0,7200.0,965,1948,.495,654,1105,.592,311,843,.369,538,681,.790,316,892,1208,505,259,109,402,515,2779,77.2,1437.0,2017.0
virginia,34.0,6900.0,839,1823,.460,607,1221,.497,232,602,.385,336,474,.709,297,822,1119,473,190,138,324,556,2246,66.1,1438.0,2017.0
west-virginia,37.0,7525.0,1059,2333,.454,784,1574,.498,275,759,.362,621,907,.685,534,853,1387,607,371,176,455,756,3014,81.5,1452.0,2017.0
wisconsin,37.0,7500.0,971,2135,.455,688,1347,.511,283,788,.359,453,703,.644,460,917,1377,504,250,130,411,602,2678,72.4,1458.0,2017.0
xavier,38.0,7625.0,981,2148,.457,714,1373,.520,267,775,.345,607,882,.688,451,965,1416,560,228,100,478,711,2836,74.6,1462.0,2017.0
arkansas,36.0,7200.0,997,2165,.461,764,1527,.500,233,638,.365,628,825,.761,401,897,1298,497,278,170,428,739,2855,79.3,1116.0,2017.0
baylor,35.0,7000.0,921,1956,.471,691,1315,.525,230,641,.359,478,661,.723,451,878,1329,544,180,166,469,617,2550,72.9,1124.0,2017.0
cincinnati,36.0,7250.0,969,2116,.458,705,1352,.521,264,764,.346,472,688,.686,437,891,1328,557,261,173,361,566,2674,74.3,1153.0,2017.0
duke,37.0,7400.0,1019,2144,.475,708,1322,.536,311,822,.378,642,842,.762,390,951,1341,484,226,172,421,675,2991,80.8,1181.0,2017.0
kansas,36.0,7275.0,1071,2193,.488,753,1406,.536,318,787,.404,535,789,.678,428,965,1393,584,250,162,456,639,2995,83.2,1242.0,2017.0
kentucky,38.0,7625.0,1134,2396,.473,867,1639,.529,267,757,.353,690,980,.704,470,1042,1512,585,229,200,443,716,3225,84.9,1246.0,2017.0
louisville,34.0,6850.0,952,2085,.457,714,1415,.505,238,670,.355,486,708,.686,457,886,1343,461,227,186,374,652,2628,77.3,1257.0,2017.0
michigan,38.0,7675.0,1002,2076,.483,641,1139,.563,361,937,.385,486,624,.779,280,831,1111,527,220,108,348,571,2851,75.0,1276.0,2017.0
michigan-state,35.0,7025.0,905,1927,.470,632,1195,.529,273,732,.373,432,646,.669,328,947,1275,591,151,162,490,699,2515,71.9,1277.0,2017.0
north-carolina,40.0,8025.0,1226,2633,.466,943,1835,.514,283,798,.355,642,916,.701,630,1118,1748,722,283,139,473,711,3377,84.4,1314.0,2017.0
oregon,39.0,7825.0,1091,2270,.481,757,1390,.545,334,880,.380,560,787,.712,412,1019,1431,614,253,248,454,614,3076,78.9,1332.0,2017.0
rhode-island,35.0,7025.0,916,2019,.454,699,1366,.512,217,653,.332,528,791,.668,409,892,1301,467,227,206,389,725,2577,73.6,1348.0,2017.0
south-carolina,37.0,7525.0,924,2197,.421,676,1464,.462,248,733,.338,611,874,.699,464,882,1346,468,288,142,480,751,2707,73.2,1376.0,2017.0
ucla,36.0,7200.0,1210,2320,.522,856,1448,.591,354,872,.406,459,622,.738,343,1043,1386,771,212,191,404,583,3233,89.8,1417.0,2017.0
wichita-state,36.0,7200.0,992,2114,.469,682,1345,.507,310,769,.403,622,848,.733,434,1038,1472,586,235,140,406,676,2916,81.0,1455.0,2017.0
wake-forest,33.0,6600.0,923,1955,.472,655,1258,.521,268,697,.385,619,795,.779,349,850,1199,512,183,121,389,668,2733,82.8,1448.0,2017.0
new-orleans,32.0,6500.0,830,1755,.473,691,1317,.525,139,438,.317,532,749,.710,386,754,1140,500,252,97,534,562,2331,72.8,1309.0,2017.0
north-carolina-central,34.0,6800.0,910,2005,.454,655,1244,.527,255,761,.335,467,684,.683,397,916,1313,480,209,112,406,587,2542,74.8,1300.0,2017.0
providence,33.0,6625.0,804,1795,.448,565,1150,.491,239,645,.371,472,683,.691,294,807,1101,471,218,98,412,569,2319,70.3,1344.0,2017.0
north-dakota,32.0,6500.0,926,1919,.483,698,1334,.523,228,585,.390,498,698,.713,297,849,1146,487,251,93,419,672,2578,80.6,1315.0,2017.0
winthrop,33.0,6750.0,891,1957,.455,578,1118,.517,313,839,.373,520,725,.717,316,908,1224,423,216,169,430,605,2615,79.2,1457.0,2017.0
east-tennessee-state,35.0,7075.0,960,1967,.488,695,1274,.546,265,693,.382,597,850,.702,357,912,1269,516,293,162,519,698,2782,79.5,1190.0,2017.0
florida-gulf-coast,34.0,6850.0,1007,2017,.499,786,1381,.569,221,636,.347,466,664,.702,379,890,1269,527,207,116,421,635,2701,79.4,1195.0,2017.0
south-dakota-state,35.0,7075.0,881,1938,.455,563,1055,.534,318,883,.360,603,782,.771,316,913,1229,459,180,83,453,584,2683,76.7,1355.0,2017.0
nevada,35.0,7025.0,933,2082,.448,613,1245,.492,320,837,.382,606,859,.705,386,965,1351,559,189,152,386,581,2792,79.8,1305.0,2017.0
minnesota,34.0,6950.0,887,2037,.435,678,1427,.475,209,610,.343,573,806,.711,378,963,1341,507,194,227,393,577,2556,75.2,1278.0,2017.0
vanderbilt,35.0,7025.0,815,1896,.430,469,975,.481,346,921,.376,513,660,.777,286,922,1208,450,147,133,430,581,2489,71.1,1435.0,2017.0
princeton,30.0,6025.0,772,1716,.450,474,927,.511,298,789,.378,307,416,.738,247,756,1003,426,200,93,298,482,2149,71.6,1343.0,2017.0
vermont,35.0,7000.0,943,1909,.494,714,1288,.554,229,621,.369,456,651,.700,326,866,1192,476,199,151,392,555,2571,73.5,1436.0,2017.0
virginia-commonwealth,35.0,7100.0,945,2050,.461,746,1448,.515,199,602,.331,527,747,.705,386,889,1275,525,263,138,435,728,2616,74.7,1433.0,2017.0
north-carolina-wilmington,35.0,7025.0,1071,2231,.480,735,1314,.559,336,917,.366,489,708,.691,422,839,1261,564,234,115,363,699,2967,84.8,1423.0,2017.0
bucknell,35.0,7000.0,942,1961,.480,656,1207,.543,286,754,.379,497,730,.681,302,901,1203,510,252,134,466,655,2669,76.3,1137.0,2017.0
virginia-tech,33.0,6650.0,887,1813,.489,597,1093,.546,290,720,.403,546,741,.737,240,828,1068,497,131,91,398,543,2610,79.1,1439.0,2017.0
maryland,33.0,6625.0,827,1840,.449,555,1083,.512,272,757,.359,512,732,.699,351,822,1173,472,180,154,426,613,2438,73.9,1268.0,2017.0
seton-hall,33.0,6675.0,872,1949,.447,670,1351,.496,202,598,.338,471,733,.643,439,872,1311,405,228,82,449,613,2417,73.2,1371.0,2017.0
new-mexico-state,34.0,6825.0,913,1957,.467,661,1210,.546,252,747,.337,600,843,.712,436,903,1339,505,166,128,465,627,2678,78.8,1308.0,2017.0
troy,37.0,7425.0,982,2153,.456,671,1286,.522,311,867,.359,614,847,.725,409,953,1362,484,221,129,462,654,2889,78.1,1407.0,2017.0
northern-kentucky,35.0,7000.0,928,2037,.456,628,1178,.533,300,859,.349,503,740,.680,391,928,1319,486,200,98,468,622,2659,76.0,1297.0,2017.0
jacksonville-state,35.0,7050.0,857,1869,.459,599,1184,.506,258,685,.377,462,647,.714,355,889,1244,493,157,134,477,628,2434,69.5,1240.0,2017.0
oklahoma-state,33.0,6600.0,957,2050,.467,663,1318,.503,294,732,.402,620,786,.789,454,761,1215,486,252,99,432,730,2828,85.7,1329.0,2017.0
miami-fl,33.0,6625.0,813,1800,.452,604,1213,.498,209,587,.356,443,617,.718,363,813,1176,389,213,125,417,513,2278,69.0,1274.0,2017.0
texas-southern,35.0,7050.0,866,2015,.430,661,1322,.500,205,693,.296,656,893,.735,401,827,1228,409,250,111,407,607,2593,74.1,1411.0,2017.0
iona,35.0,7075.0,979,2155,.454,637,1293,.493,342,862,.397,513,668,.768,337,913,1250,541,239,108,421,669,2813,80.4,1233.0,2017.0
creighton,35.0,7000.0,1078,2137,.504,774,1371,.565,304,766,.397,404,592,.682,289,934,1223,598,213,102,435,582,2864,81.8,1166.0,2017.0
marquette,32.0,6425.0,919,1888,.487,583,1105,.528,336,783,.429,457,585,.781,280,778,1058,525,231,115,396,620,2631,82.2,1266.0,2017.0
kent-state,36.0,7325.0,986,2302,.428,729,1499,.486,257,803,.320,543,755,.719,539,915,1454,449,230,134,465,685,2772,77.0,1245.0,2017.0
southern-methodist,35.0,7000.0,914,1934,.473,628,1229,.511,286,705,.406,485,696,.697,416,919,1335,566,200,117,377,506,2599,74.3,1374.0,2017.0
dayton,32.0,6425.0,820,1763,.465,562,1092,.515,258,671,.385,530,768,.690,277,820,1097,500,249,128,376,601,2428,75.9,1173.0,2017.0
radford,36.0,7325.0,850,2000,.425,573,1207,.475,277,793,.349,445,614,.725,415,829,1244,442,226,105,441,596,2422,67.3,1347.0,2018.0
st-bonaventure,34.0,6900.0,884,1959,.451,629,1298,.485,255,661,.386,597,794,.752,344,864,1208,472,239,118,391,674,2620,77.1,1382.0,2018.0
syracuse,37.0,7500.0,832,1995,.417,624,1340,.466,208,655,.318,594,807,.736,442,933,1375,395,258,198,460,611,2466,66.6,1393.0,2018.0
texas-southern,36.0,7250.0,925,2111,.438,645,1330,.485,280,781,.359,657,906,.725,372,929,1301,438,207,145,453,631,2787,77.4,1411.0,2018.0
alabama,36.0,7200.0,910,1975,.461,681,1273,.535,229,702,.326,555,828,.670,360,930,1290,458,228,192,513,676,2604,72.3,1104.0,2018.0
buffalo,36.0,7275.0,1105,2334,.473,754,1386,.544,351,948,.370,486,695,.699,430,958,1388,597,225,146,446,755,3047,84.6,1138.0,2018.0
duke,37.0,7450.0,1125,2288,.492,816,1457,.560,309,831,.372,562,791,.710,496,1023,1519,648,275,185,460,574,3121,84.4,1181.0,2018.0
florida,34.0,6875.0,893,2065,.432,585,1233,.474,308,832,.370,483,673,.718,367,831,1198,445,237,164,335,591,2577,75.8,1196.0,2018.0
gonzaga,37.0,7500.0,1125,2261,.498,797,1370,.582,328,891,.368,513,725,.708,413,1064,1477,564,234,134,420,631,3091,83.5,1211.0,2018.0
houston,35.0,7000.0,952,2066,.461,655,1298,.505,297,768,.387,484,674,.718,408,944,1352,505,218,106,418,737,2685,76.7,1222.0,2018.0
kansas,39.0,7825.0,1165,2366,.492,774,1392,.556,391,974,.401,453,640,.708,381,1007,1388,649,254,160,456,597,3174,81.4,1242.0,2018.0
kentucky,37.0,7425.0,998,2115,.472,803,1569,.512,195,546,.357,649,930,.698,441,990,1431,489,208,176,480,702,2840,76.8,1246.0,2018.0
loyola-il,38.0,7600.0,995,1963,.507,718,1263,.568,277,700,.396,454,626,.725,238,984,1222,594,241,90,472,528,2721,71.6,1260.0,2018.0
michigan,41.0,8275.0,1092,2335,.468,731,1324,.552,361,1011,.357,474,717,.661,345,1022,1367,585,261,126,379,643,3019,73.6,1276.0,2018.0
ohio-state,34.0,6875.0,951,1980,.480,712,1302,.547,239,678,.353,450,616,.731,334,911,1245,499,209,132,399,595,2591,76.2,1326.0,2018.0
rhode-island,34.0,6850.0,954,2096,.455,718,1426,.504,236,670,.352,439,630,.697,389,781,1170,520,249,118,362,645,2583,76.0,1348.0,2018.0
seton-hall,34.0,6850.0,971,2073,.468,721,1388,.519,250,685,.365,509,729,.698,416,886,1302,527,210,117,432,614,2701,79.4,1371.0,2018.0
tennessee,35.0,7050.0,885,2012,.440,612,1294,.473,273,718,.380,541,715,.757,404,858,1262,550,222,156,422,680,2584,73.8,1397.0,2018.0
texas-tech,37.0,7450.0,964,2096,.460,712,1394,.511,252,702,.359,579,823,.704,407,925,1332,529,262,158,454,669,2759,74.6,1403.0,2018.0
villanova,40.0,8075.0,1220,2440,.500,756,1282,.590,464,1158,.401,559,718,.779,385,1051,1436,655,259,162,426,645,3463,86.6,1437.0,2018.0
auburn,34.0,6800.0,906,2102,.431,582,1194,.487,324,908,.357,647,836,.774,407,883,1290,481,252,180,411,672,2783,81.9,1120.0,2018.0
butler,35.0,7150.0,1020,2155,.473,733,1350,.543,287,805,.357,436,562,.776,324,874,1198,489,232,100,391,642,2763,78.9,1139.0,2018.0
cincinnati,36.0,7200.0,944,2100,.450,682,1358,.502,262,742,.353,523,756,.692,479,934,1413,570,256,194,404,561,2673,74.3,1153.0,2018.0
clemson,35.0,7050.0,899,1971,.456,611,1185,.516,288,786,.366,498,660,.755,313,943,1256,463,198,169,414,564,2584,73.8,1155.0,2018.0
florida-state,35.0,7100.0,994,2125,.468,721,1344,.536,273,781,.350,543,786,.691,398,924,1322,523,241,186,456,652,2806,80.2,1199.0,2018.0
kansas-state,37.0,7425.0,937,2025,.463,683,1280,.534,254,745,.341,502,684,.734,304,832,1136,510,294,110,423,684,2630,71.1,1243.0,2018.0
marshall,36.0,7275.0,1042,2232,.467,680,1220,.557,362,1012,.358,571,747,.764,293,994,1287,615,252,209,476,617,3017,83.8,1267.0,2018.0
michigan-state,35.0,7025.0,991,1996,.496,701,1271,.552,290,725,.400,535,716,.747,405,1034,1439,670,143,251,459,640,2807,80.2,1277.0,2018.0
nevada,37.0,7500.0,1049,2238,.469,695,1334,.521,354,904,.392,603,812,.743,342,974,1316,598,230,150,357,630,3055,82.6,1305.0,2018.0
north-carolina,37.0,7425.0,1105,2417,.457,800,1568,.510,305,849,.359,503,677,.743,511,1059,1570,674,213,151,445,587,3018,81.6,1314.0,2018.0
purdue,37.0,7425.0,1033,2097,.493,680,1257,.541,353,840,.420,555,747,.743,319,976,1295,598,211,180,399,580,2974,80.4,1345.0,2018.0
texas-am,35.0,7000.0,976,2121,.460,746,1421,.525,230,700,.329,449,679,.661,432,1018,1450,538,190,209,476,574,2631,75.2,1401.0,2018.0
maryland-baltimore-county,36.0,7200.0,926,2088,.443,562,1148,.490,364,940,.387,414,641,.646,348,897,1245,547,269,87,440,592,2630,73.1,1420.0,2018.0
west-virginia,37.0,7425.0,1036,2374,.436,714,1463,.488,322,911,.353,570,744,.766,521,880,1401,561,301,192,420,798,2964,80.1,1452.0,2018.0
xavier,35.0,7075.0,1011,2055,.492,737,1319,.559,274,736,.372,657,843,.779,345,997,1342,579,205,109,441,602,2953,84.4,1462.0,2018.0
long-island-university,35.0,7025.0,935,2055,.455,656,1240,.529,279,815,.342,547,786,.696,370,957,1327,442,194,111,496,687,2696,77.0,1254.0,2018.0
ucla,33.0,6750.0,927,2014,.460,617,1201,.514,310,813,.381,515,715,.720,337,946,1283,495,184,131,399,592,2679,81.2,1417.0,2018.0
arizona-state,32.0,6450.0,888,1920,.463,600,1127,.532,288,793,.363,581,793,.733,315,811,1126,458,209,114,343,604,2645,82.7,1113.0,2018.0
north-carolina-central,35.0,7025.0,949,2060,.461,737,1420,.519,212,640,.331,410,597,.687,415,921,1336,545,179,117,495,650,2520,72.0,1300.0,2018.0
virginia-tech,33.0,6675.0,931,1865,.499,642,1120,.573,289,745,.388,483,681,.709,246,832,1078,542,191,74,395,523,2634,79.8,1439.0,2018.0
arizona,35.0,7100.0,1009,2003,.504,772,1361,.567,237,642,.369,563,741,.760,353,924,1277,531,173,158,426,603,2818,80.5,1112.0,2018.0
iona,34.0,6925.0,957,2076,.461,633,1230,.515,324,846,.383,462,626,.738,291,855,1146,542,229,103,395,587,2702,79.5,1233.0,2018.0
north-carolina-greensboro,35.0,7150.0,924,2075,.445,593,1137,.522,331,938,.353,383,549,.698,418,889,1307,487,267,132,481,650,2562,73.2,1422.0,2018.0
san-diego-state,33.0,6600.0,902,1967,.459,663,1258,.527,239,709,.337,502,702,.715,366,884,1250,488,206,107,394,564,2545,77.1,1361.0,2018.0
pennsylvania,33.0,6775.0,893,1948,.458,602,1117,.539,291,831,.350,429,651,.659,283,956,1239,508,194,92,391,566,2506,75.9,1335.0,2018.0
davidson,33.0,6675.0,899,1874,.480,546,967,.565,353,907,.389,368,461,.798,229,849,1078,551,155,65,315,503,2519,76.3,1172.0,2018.0
miami-fl,32.0,6450.0,875,1881,.465,628,1203,.522,247,678,.364,362,547,.662,318,795,1113,424,210,130,367,518,2361,73.8,1274.0,2018.0
montana,34.0,6900.0,944,2021,.467,758,1472,.515,186,549,.339,551,780,.706,402,856,1258,428,264,114,422,716,2625,77.2,1285.0,2018.0
south-dakota-state,35.0,7075.0,1003,2147,.467,629,1220,.516,374,927,.403,578,759,.762,310,1050,1360,467,172,80,353,562,2958,84.5,1355.0,2018.0
oklahoma,32.0,6475.0,954,2063,.462,654,1227,.533,300,836,.359,510,684,.746,339,890,1229,479,208,151,428,551,2718,84.9,1328.0,2018.0
north-carolina-state,33.0,6625.0,965,2054,.470,702,1347,.521,263,707,.372,489,703,.696,401,775,1176,531,244,122,400,609,2682,81.3,1301.0,2018.0
wright-state,35.0,7050.0,873,2019,.432,636,1316,.483,237,703,.337,517,723,.715,356,910,1266,460,231,77,459,558,2500,71.4,1460.0,2018.0
stephen-f-austin,35.0,7000.0,1000,2059,.486,758,1408,.538,242,651,.372,577,819,.705,402,846,1248,498,361,107,540,765,2819,80.5,1372.0,2018.0
college-of-charleston,34.0,6925.0,875,1905,.459,616,1185,.520,259,720,.360,527,699,.754,286,843,1129,387,177,119,339,563,2536,74.6,1158.0,2018.0
arkansas,35.0,7075.0,1005,2119,.474,736,1438,.512,269,681,.395,540,793,.681,351,857,1208,501,218,163,381,700,2819,80.5,1116.0,2018.0
georgia-state,35.0,7075.0,937,2033,.461,614,1194,.514,323,839,.385,417,615,.678,309,873,1182,455,256,160,395,639,2614,74.7,1209.0,2018.0
new-mexico-state,34.0,6825.0,963,2104,.458,705,1331,.530,258,773,.334,388,603,.643,427,975,1402,481,189,103,429,604,2572,75.6,1308.0,2018.0
missouri,33.0,6650.0,794,1765,.450,488,966,.505,306,799,.383,505,688,.734,333,892,1225,443,170,140,469,594,2399,72.7,1281.0,2018.0
creighton,33.0,6650.0,1008,2050,.492,665,1127,.590,343,923,.372,397,531,.748,249,957,1206,588,187,88,371,501,2756,83.5,1166.0,2018.0
wichita-state,33.0,6650.0,957,2009,.476,657,1222,.538,300,787,.381,517,700,.739,405,931,1336,610,154,127,385,580,2731,82.8,1455.0,2018.0
bucknell,35.0,7100.0,965,2050,.471,685,1246,.550,280,804,.348,627,872,.719,325,956,1281,505,194,152,437,655,2837,81.1,1137.0,2018.0
texas,34.0,7050.0,882,2010,.439,637,1244,.512,245,766,.320,441,663,.665,361,856,1217,394,209,168,399,547,2450,72.1,1400.0,2018.0
lipscomb,33.0,6700.0,924,2040,.453,657,1227,.535,267,813,.328,593,826,.718,346,930,1276,517,216,102,493,656,2708,82.1,1252.0,2018.0
cal-state-fullerton,32.0,6450.0,804,1721,.467,637,1221,.522,167,500,.334,543,745,.729,280,843,1123,403,201,106,455,578,2318,72.4,1168.0,2018.0
texas-christian,33.0,6725.0,979,1973,.496,705,1279,.551,274,694,.395,476,674,.706,368,833,1201,615,214,119,419,553,2708,82.1,1395.0,2018.0
providence,35.0,7125.0,899,2037,.441,676,1366,.495,223,671,.332,554,787,.704,369,878,1247,485,238,128,430,624,2575,73.6,1344.0,2018.0
virginia,34.0,6825.0,848,1844,.460,601,1199,.501,247,645,.383,340,451,.754,282,817,1099,458,232,124,290,480,2283,67.1,1438.0,2018.0
murray-state,32.0,6400.0,870,1803,.483,599,1084,.553,271,719,.377,504,687,.734,341,845,1186,471,216,104,384,559,2515,78.6,1293.0,2018.0
belmont,33.0,6650.0,1042,2094,.498,699,1172,.596,343,922,.372,441,598,.737,286,989,1275,645,220,125,376,509,2868,86.9,1125.0,2019.0
fairleigh-dickinson,35.0,7100.0,921,1939,.475,652,1267,.515,269,672,.400,509,702,.725,323,832,1155,486,261,132,477,578,2620,74.9,1192.0,2019.0
arizona-state,34.0,6900.0,899,2012,.447,659,1298,.508,240,714,.336,600,882,.680,399,952,1351,459,213,109,466,675,2638,77.6,1113.0,2019.0
north-dakota-state,35.0,7050.0,874,1926,.454,542,1016,.533,332,910,.365,476,613,.777,229,876,1105,402,160,87,368,523,2556,73.0,1295.0,2019.0
auburn,40.0,8075.0,1097,2439,.450,643,1235,.521,454,1204,.377,540,760,.711,457,912,1369,572,369,190,466,731,3188,79.7,1120.0,2019.0
baylor,34.0,6825.0,869,1966,.442,595,1163,.512,274,803,.341,430,635,.677,450,831,1281,473,209,159,446,636,2442,71.8,1124.0,2019.0
florida,36.0,7275.0,857,2015,.425,566,1143,.495,291,872,.334,435,603,.721,375,826,1201,437,257,131,420,614,2440,67.8,1196.0,2019.0
florida-state,37.0,7500.0,960,2171,.442,688,1352,.509,272,819,.332,579,778,.744,418,973,1391,475,266,161,492,705,2771,74.9,1199.0,2019.0
gonzaga,37.0,7400.0,1177,2239,.526,890,1449,.614,287,790,.363,602,791,.761,354,1089,1443,668,278,204,394,603,3243,87.6,1211.0,2019.0
kansas,36.0,7275.0,989,2128,.465,729,1385,.526,260,743,.350,487,691,.705,374,1002,1376,478,243,139,472,610,2725,75.7,1242.0,2019.0
kentucky,37.0,7450.0,978,2050,.477,763,1443,.529,215,607,.354,635,859,.739,427,1001,1428,501,220,176,466,600,2806,75.8,1246.0,2019.0
louisiana-state,35.0,7175.0,988,2162,.457,752,1422,.529,236,740,.319,603,802,.752,460,895,1355,452,308,148,452,634,2815,80.4,1261.0,2019.0
maryland,34.0,6800.0,858,1909,.449,611,1202,.508,247,707,.349,466,627,.743,378,958,1336,447,148,163,437,526,2429,71.4,1268.0,2019.0
michigan,37.0,7400.0,941,2102,.448,654,1263,.518,287,839,.342,406,579,.701,299,1008,1307,512,225,149,334,514,2575,69.6,1276.0,2019.0
michigan-state,39.0,7850.0,1071,2230,.480,752,1386,.543,319,844,.378,564,749,.753,414,1165,1579,715,201,205,493,647,3025,77.6,1277.0,2019.0
minnesota,36.0,7225.0,887,2039,.435,696,1436,.485,191,603,.317,578,848,.682,402,912,1314,523,175,140,418,578,2543,70.6,1278.0,2019.0
murray-state,33.0,6600.0,988,2007,.492,730,1276,.572,258,731,.353,493,673,.733,351,896,1247,591,249,149,401,527,2727,82.6,1293.0,2019.0
purdue,36.0,7300.0,967,2145,.451,602,1168,.515,365,977,.374,461,641,.719,421,920,1341,518,220,143,381,625,2760,76.7,1345.0,2019.0
villanova,36.0,7275.0,884,2019,.438,504,938,.537,380,1081,.352,506,695,.728,368,885,1253,503,194,106,388,580,2654,73.7,1437.0,2019.0
wofford,35.0,7050.0,1044,2132,.490,659,1203,.548,385,929,.414,406,577,.704,365,867,1232,528,233,105,377,589,2879,82.3,1459.0,2019.0
buffalo,36.0,7225.0,1083,2344,.462,739,1322,.559,344,1022,.337,527,767,.687,452,1018,1470,599,263,140,433,659,3037,84.4,1138.0,2019.0
duke,38.0,7625.0,1157,2418,.478,879,1515,.580,278,903,.308,551,803,.686,495,1072,1567,606,346,257,488,595,3143,82.7,1181.0,2019.0
houston,37.0,7400.0,982,2203,.446,649,1264,.513,333,939,.355,490,697,.703,448,1054,1502,548,240,161,410,705,2787,75.3,1222.0,2019.0
iowa,35.0,7075.0,914,2006,.456,629,1224,.514,285,782,.364,627,849,.739,357,889,1246,542,211,112,427,565,2740,78.3,1234.0,2019.0
liberty,36.0,7200.0,963,1977,.487,641,1104,.581,322,873,.369,406,524,.775,270,904,1174,532,223,96,395,543,2654,73.7,1251.0,2019.0
north-carolina,36.0,7225.0,1118,2410,.464,806,1548,.521,312,862,.362,541,728,.743,477,1112,1589,678,252,120,473,611,3089,85.8,1314.0,2019.0
ohio-state,35.0,7025.0,839,1931,.434,575,1157,.497,264,774,.341,477,650,.734,328,887,1215,494,206,85,438,623,2419,69.1,1326.0,2019.0
oklahoma,34.0,6825.0,883,1975,.447,657,1321,.497,226,654,.346,431,618,.697,305,958,1263,430,203,102,401,527,2423,71.3,1328.0,2019.0
oregon,38.0,7650.0,958,2126,.451,663,1286,.516,295,840,.351,450,624,.721,361,946,1307,501,290,162,442,665,2661,70.0,1332.0,2019.0
tennessee,37.0,7525.0,1106,2231,.496,844,1517,.556,262,714,.367,561,744,.754,379,1012,1391,660,221,199,412,654,3035,82.0,1397.0,2019.0
texas-tech,38.0,7650.0,990,2110,.469,713,1351,.528,277,759,.365,508,694,.732,315,982,1297,518,278,186,457,663,2765,72.8,1403.0,2019.0
california-irvine,37.0,7500.0,987,2159,.457,735,1458,.504,252,701,.359,449,640,.702,429,1042,1471,479,210,153,441,673,2675,72.3,1414.0,2019.0
central-florida,33.0,6625.0,819,1763,.465,590,1135,.520,229,628,.365,518,798,.649,315,900,1215,439,189,150,393,554,2385,72.3,1416.0,2019.0
virginia,38.0,7675.0,974,2056,.474,653,1243,.525,321,813,.395,445,598,.744,342,984,1326,544,211,149,342,542,2714,71.4,1438.0,2019.0
virginia-tech,35.0,7050.0,893,1900,.470,566,1069,.529,327,831,.394,461,606,.761,310,832,1142,531,236,78,392,532,2574,73.5,1439.0,2019.0
washington,36.0,7225.0,883,1956,.451,610,1176,.519,273,780,.350,472,679,.695,334,795,1129,419,323,206,479,653,2511,69.8,1449.0,2019.0
temple,33.0,6700.0,873,1998,.437,626,1250,.501,247,748,.330,472,649,.727,316,820,1136,476,284,73,368,581,2465,74.7,1396.0,2019.0
prairie-view,35.0,7000.0,903,2061,.438,678,1358,.499,225,703,.320,596,875,.681,392,759,1151,445,309,55,445,758,2627,75.1,1341.0,2019.0
st-johns-ny,34.0,6875.0,944,2100,.450,655,1291,.507,289,809,.357,446,620,.719,264,856,1120,472,302,111,357,650,2623,77.1,1385.0,2019.0
north-carolina-central,34.0,6825.0,874,1922,.455,653,1229,.531,221,693,.319,460,641,.718,399,866,1265,526,207,93,515,610,2429,71.4,1300.0,2019.0
new-mexico-state,35.0,7025.0,962,2092,.460,636,1115,.570,326,977,.334,484,714,.678,445,898,1343,514,197,91,419,632,2734,78.1,1308.0,2019.0
syracuse,34.0,6825.0,808,1907,.424,534,1083,.493,274,824,.333,480,701,.685,363,811,1174,408,278,162,423,588,2370,69.7,1393.0,2019.0
nevada,34.0,6800.0,924,1999,.462,627,1144,.548,297,855,.347,578,816,.708,325,949,1274,498,211,134,352,584,2723,80.1,1305.0,2019.0
vermont,34.0,6850.0,864,1887,.458,591,1126,.525,273,761,.359,507,678,.748,304,890,1194,399,188,136,377,568,2508,73.8,1436.0,2019.0
northeastern,34.0,6925.0,880,1848,.476,552,990,.558,328,858,.382,476,634,.751,237,838,1075,480,211,74,381,539,2564,75.4,1318.0,2019.0
abilene-christian,34.0,6850.0,897,1911,.469,646,1251,.516,251,660,.380,457,642,.712,325,785,1110,525,297,93,407,635,2502,73.6,1101.0,2019.0
yale,30.0,6075.0,893,1812,.493,663,1178,.563,230,634,.363,411,557,.738,259,898,1157,503,177,131,392,510,2427,80.9,1463.0,2019.0
montana,35.0,7025.0,975,1983,.492,688,1220,.564,287,763,.376,428,621,.689,293,883,1176,510,229,106,416,655,2665,76.1,1285.0,2019.0
bradley,35.0,7025.0,812,1874,.433,572,1221,.468,240,653,.368,465,672,.692,313,882,1195,423,186,132,440,617,2329,66.5,1133.0,2019.0
louisville,34.0,6900.0,854,1967,.434,560,1107,.506,294,860,.342,534,687,.777,345,952,1297,458,149,99,412,591,2536,74.6,1257.0,2019.0
marquette,34.0,6875.0,893,1969,.454,574,1147,.500,319,822,.388,524,692,.757,331,961,1292,456,168,145,467,635,2629,77.3,1266.0,2019.0
old-dominion,35.0,7000.0,823,2026,.406,559,1270,.440,264,756,.349,388,585,.663,418,947,1365,439,197,160,408,580,2300,65.7,1330.0,2019.0
saint-marys-ca,34.0,6825.0,899,1905,.472,646,1235,.523,253,670,.378,412,555,.742,329,851,1180,341,201,87,355,572,2463,72.4,1388.0,2019.0
seton-hall,34.0,6875.0,888,2021,.439,648,1280,.506,240,741,.324,492,697,.706,361,852,1213,459,235,132,423,638,2508,73.8,1371.0,2019.0
georgia-state,34.0,6800.0,903,1968,.459,573,1109,.517,330,859,.384,462,694,.666,273,837,1110,415,269,158,391,583,2598,76.4,1209.0,2019.0
cincinnati,35.0,7050.0,872,2018,.432,640,1345,.476,232,673,.345,534,758,.704,442,822,1264,466,214,155,365,563,2510,71.7,1153.0,2019.0
mississippi-state,34.0,6850.0,936,1982,.472,644,1208,.533,292,774,.377,464,647,.717,393,822,1215,481,274,172,451,586,2628,77.3,1280.0,2019.0
iona,33.0,6600.0,857,1897,.452,560,1052,.532,297,845,.351,521,699,.745,283,869,1152,432,223,90,406,564,2532,76.7,1233.0,2019.0
iowa-state,35.0,7000.0,974,2047,.476,680,1236,.550,294,811,.363,450,615,.732,327,903,1230,527,247,160,379,517,2692,76.9,1235.0,2019.0
mississippi,33.0,6625.0,876,1906,.460,604,1146,.527,272,760,.358,461,589,.783,322,806,1128,475,235,118,416,603,2485,75.3,1279.0,2019.0
wisconsin,34.0,6925.0,874,1945,.449,633,1273,.497,241,672,.359,344,531,.648,283,914,1197,430,177,140,327,511,2333,68.6,1458.0,2019.0
colgate,35.0,7075.0,955,1995,.479,635,1180,.538,320,815,.393,418,563,.742,322,918,1240,541,213,121,456,547,2648,75.7,1159.0,2019.0
northern-kentucky,35.0,7050.0,979,2047,.478,673,1203,.559,306,844,.363,483,725,.666,364,934,1298,592,218,139,441,664,2747,78.5,1297.0,2019.0
kansas-state,34.0,6800.0,806,1878,.429,565,1157,.488,241,721,.334,383,574,.667,325,812,1137,464,256,76,385,550,2236,65.8,1243.0,2019.0
virginia-commonwealth,33.0,6650.0,820,1872,.438,585,1101,.531,235,771,.305,469,669,.701,358,850,1208,450,263,148,458,650,2344,71.0,1433.0,2019.0
gardner-webb,35.0,7150.0,955,1962,.487,674,1243,.542,281,719,.391,527,741,.711,271,919,1190,502,238,101,407,561,2718,77.7,1205.0,2019.0
saint-louis,36.0,7200.0,855,2052,.417,650,1377,.472,205,675,.304,484,809,.598,492,936,1428,460,254,145,464,634,2399,66.6,1387.0,2019.0
utah-state,35.0,7050.0,959,2038,.471,685,1266,.541,274,772,.355,559,747,.748,377,1028,1405,598,215,147,449,649,2753,78.7,1429.0,2019.0
