team_id,FG,FGA,FG%,2P,2PA,2P%,3P,3PA,3P%,FT,FTA,FT%,ORB,DRB,TRB,AST,STL,BLK,TOV,PF,PTS/G,W-L%,SRS,SOS,PTS.1,Seed
100001,865,1978,0.43700000000000006,677,1413,0.479,188,565,0.33299999999999996,593,823,0.721,498,902,1400,464,239,139,557,657,69.8,0.556,-3.14,-3.61,67.0,16.0
100002,996,2102,0.474,831,1618,0.514,165,484,0.341,662,976,0.6779999999999999,511,1048,1559,567,209,280,458,471,78.3,0.861,22.17,8.57,64.3,1.0
100003,971,2186,0.444,704,1420,0.496,267,766,0.349,658,904,0.728,490,858,1348,492,311,146,454,671,77.5,0.8109999999999999,20.1,9.07,65.9,2.0
100004,967,1982,0.488,716,1339,0.535,251,643,0.39,499,696,0.7170000000000001,345,931,1276,512,246,174,386,551,78.9,0.8240000000000001,17.95,3.55,63.0,4.0
100005,937,2093,0.44799999999999995,724,1521,0.47600000000000003,213,572,0.37200000000000005,530,740,0.716,475,890,1365,529,267,212,425,609,74.8,0.7709999999999999,11.87,3.27,66.2,8.0
100006,924,2179,0.424,723,1575,0.45899999999999996,201,604,0.33299999999999996,463,611,0.758,464,810,1274,511,268,145,428,582,71.8,0.6,11.1,8.99,69.1,10.0
100007,979,2176,0.45,757,1495,0.506,222,681,0.326,599,868,0.69,498,954,1452,526,328,222,464,654,75.1,0.892,20.92,4.63,58.8,2.0
100008,812,1910,0.425,507,998,0.508,305,912,0.33399999999999996,412,544,0.757,336,751,1087,542,223,92,402,535,66.9,0.6,11.9,9.74,63.2,10.0
100009,1205,2509,0.48,941,1827,0.515,264,682,0.387,739,983,0.752,556,1038,1594,685,325,196,472,608,89.8,0.895,25.46,8.35,72.0,1.0
100010,982,1997,0.49200000000000005,740,1308,0.5660000000000001,242,689,0.35100000000000003,627,929,0.675,435,967,1402,521,249,156,500,616,78.7,0.833,18.07,6.88,67.5,2.0
100011,914,2071,0.441,670,1367,0.49,244,704,0.34700000000000003,483,687,0.703,363,908,1271,552,265,176,426,650,69.1,0.73,16.44,7.17,59.8,5.0
100012,917,2063,0.444,751,1497,0.502,166,566,0.293,532,797,0.6679999999999999,496,863,1359,448,217,187,442,674,72.3,0.657,14.83,8.09,65.6,7.0
100013,822,1831,0.449,620,1271,0.488,202,560,0.361,594,856,0.6940000000000001,422,827,1249,427,164,133,432,585,71.8,0.706,10.52,6.13,67.1,9.0
100014,967,1973,0.49,705,1317,0.535,262,656,0.39899999999999997,446,616,0.7240000000000001,395,756,1151,541,292,110,440,598,75.5,0.743,18.64,7.19,64.0,6.0
100015,990,2193,0.451,743,1492,0.498,247,701,0.35200000000000004,692,919,0.753,477,972,1449,551,300,128,505,735,76.8,0.789,17.45,8.72,67.4,3.0
100016,871,1929,0.452,605,1215,0.498,266,714,0.373,446,647,0.6890000000000001,432,819,1251,454,193,111,452,587,72.2,0.735,3.68,-1.23,67.0,12.0
100017,977,2136,0.457,831,1703,0.488,146,433,0.337,650,929,0.7,532,905,1437,458,259,95,515,683,78.6,0.743,16.78,8.19,69.5,4.0
100018,897,1892,0.474,685,1344,0.51,212,548,0.387,523,709,0.738,387,796,1183,500,217,104,442,548,72.3,0.6,11.88,8.8,69.2,12.0
100019,825,1718,0.48,537,940,0.5710000000000001,288,778,0.37,490,665,0.737,288,797,1085,544,201,72,401,557,69.4,0.7140000000000001,16.7,7.82,60.5,6.0
100020,882,2043,0.43200000000000005,702,1465,0.479,180,578,0.311,511,729,0.701,441,826,1267,512,320,118,454,680,66.4,0.703,6.97,2.12,59.5,13.0
100021,831,1972,0.42100000000000004,641,1393,0.46,190,579,0.32799999999999996,487,752,0.648,484,844,1328,485,227,124,475,672,66.8,0.7709999999999999,7.16,1.76,61.4,11.0
100022,945,1979,0.478,728,1394,0.522,217,585,0.371,567,782,0.725,421,950,1371,555,239,155,508,664,76.4,0.7709999999999999,18.02,7.9,65.4,3.0
100023,1001,2189,0.457,696,1362,0.511,305,827,0.369,441,687,0.642,464,931,1395,625,335,223,508,625,74.3,0.838,20.87,8.41,61.8,1.0
100024,914,2023,0.452,671,1322,0.508,243,701,0.34700000000000003,668,918,0.728,425,822,1247,526,275,100,408,623,78.3,0.7140000000000001,15.06,7.87,69.5,6.0
100025,962,2135,0.451,761,1568,0.485,201,567,0.354,612,877,0.698,533,949,1482,611,248,107,532,734,72.0,0.816,17.71,9.37,63.7,2.0
100026,1124,2381,0.47200000000000003,861,1635,0.527,263,746,0.353,585,871,0.672,486,907,1393,699,388,140,449,758,81.5,0.816,19.56,6.72,67.7,3.0
100027,948,2059,0.46,621,1208,0.514,327,851,0.384,607,812,0.748,346,877,1223,446,266,82,431,745,80.9,0.657,13.78,7.44,74.5,8.0
100028,1040,2174,0.478,815,1534,0.531,225,640,0.35200000000000004,482,713,0.6759999999999999,533,900,1433,633,246,139,436,585,77.4,0.861,21.21,8.61,64.4,1.0
100029,1007,2157,0.467,823,1599,0.515,184,558,0.33,511,769,0.664,438,835,1273,534,309,159,462,521,77.4,0.7709999999999999,8.05,0.99,70.3,9.0
100030,1110,2277,0.48700000000000004,854,1534,0.557,256,743,0.345,570,884,0.645,482,1023,1505,687,296,194,583,580,80.2,0.737,17.24,9.48,71.7,3.0
100031,872,1843,0.473,743,1447,0.513,129,396,0.326,524,778,0.674,409,838,1247,438,224,165,487,584,68.5,0.629,14.09,9.15,63.5,10.0
100032,735,1686,0.436,522,1094,0.47700000000000004,213,592,0.36,423,583,0.726,317,703,1020,393,163,86,330,532,63.8,0.606,12.43,8.43,59.0,12.0
100033,847,1846,0.45899999999999996,608,1239,0.491,239,607,0.39399999999999996,575,851,0.6759999999999999,420,958,1378,464,185,178,511,653,71.7,0.7709999999999999,14.45,4.65,61.9,4.0
100034,816,1752,0.466,635,1202,0.528,181,550,0.32899999999999996,389,614,0.634,358,772,1130,445,182,153,435,558,68.8,0.688,-6.13,-11.2,63.3,16.0
100035,877,2002,0.43799999999999994,588,1181,0.498,289,821,0.35200000000000004,614,935,0.657,438,936,1374,477,218,79,551,648,75.9,0.514,-6.25,-3.13,76.8,16.0
100036,778,1764,0.441,586,1189,0.493,192,575,0.33399999999999996,491,733,0.67,357,744,1101,383,227,134,431,652,70.0,0.7190000000000001,-3.27,-5.62,67.4,15.0
100037,823,1969,0.418,565,1193,0.474,258,776,0.332,499,705,0.708,424,775,1199,446,270,80,490,745,66.8,0.639,3.37,-2.01,60.3,13.0
100038,705,1609,0.43799999999999994,448,878,0.51,257,731,0.35200000000000004,501,692,0.7240000000000001,328,766,1094,417,193,102,400,568,67.8,0.813,10.07,2.07,57.9,9.0
100039,892,1848,0.483,682,1356,0.503,210,492,0.42700000000000005,478,633,0.755,333,780,1113,509,159,66,399,560,74.9,0.667,13.3,7.21,68.8,7.0
100040,821,1808,0.45399999999999996,606,1199,0.505,215,609,0.353,425,611,0.696,403,747,1150,430,276,83,549,683,73.6,0.5479999999999999,2.65,-0.14,70.3,15.0
100041,912,1971,0.46299999999999997,656,1287,0.51,256,684,0.374,427,621,0.688,462,727,1189,478,298,187,456,575,78.3,0.7190000000000001,15.56,6.59,68.0,7.0
100042,884,1917,0.461,721,1454,0.496,163,463,0.35200000000000004,560,825,0.679,418,954,1372,466,225,154,539,607,75.5,0.636,-4.55,-4.37,71.9,16.0
100043,857,2047,0.419,676,1510,0.44799999999999995,181,537,0.337,438,675,0.649,508,822,1330,393,232,110,456,673,66.7,0.657,-2.29,-6.53,62.3,15.0
100044,766,1692,0.45299999999999996,549,1064,0.516,217,628,0.34600000000000003,541,718,0.753,297,843,1140,418,146,83,397,619,67.4,0.6759999999999999,5.63,2.24,63.5,12.0
100045,782,1772,0.441,594,1197,0.496,188,575,0.327,437,611,0.715,397,739,1136,466,274,201,477,588,66.3,0.667,11.32,7.19,61.6,10.0
100046,909,1879,0.484,671,1255,0.535,238,624,0.381,488,669,0.7290000000000001,302,894,1196,537,241,119,375,607,77.1,0.758,15.12,4.15,65.2,8.0
100047,866,1878,0.461,644,1277,0.504,222,601,0.369,486,689,0.705,362,790,1152,469,257,155,431,654,71.8,0.706,7.7,-0.65,63.4,11.0
100048,751,1614,0.465,521,999,0.522,230,615,0.374,333,514,0.648,302,744,1046,421,176,79,422,581,64.5,0.75,-0.05,-5.49,59.1,14.0
100049,859,1865,0.461,671,1328,0.505,188,537,0.35,298,419,0.711,320,807,1127,595,199,122,420,521,64.8,0.706,14.38,6.73,57.2,5.0
100050,890,2058,0.43200000000000005,594,1239,0.479,296,819,0.361,601,847,0.71,407,977,1384,447,250,271,517,604,74.4,0.639,9.1,4.62,68.9,13.0
100051,819,1727,0.474,577,1072,0.5379999999999999,242,655,0.369,541,693,0.7809999999999999,279,914,1193,458,171,166,469,632,71.2,0.706,12.59,5.72,64.6,5.0
100052,846,1908,0.44299999999999995,588,1205,0.488,258,703,0.36700000000000005,383,547,0.7,376,872,1248,527,189,141,426,581,68.6,0.647,9.05,3.9,63.5,11.0
100053,906,1849,0.49,780,1455,0.536,126,394,0.32,572,804,0.711,390,872,1262,405,258,176,492,584,81.0,0.774,15.63,7.36,70.7,4.0
100054,886,2067,0.429,655,1364,0.48,231,703,0.32899999999999996,518,742,0.698,532,808,1340,530,233,159,420,661,72.0,0.657,18.57,8.34,61.8,6.0
100055,943,1936,0.48700000000000004,705,1358,0.519,238,578,0.41200000000000003,535,724,0.7390000000000001,363,808,1171,486,230,108,370,539,80.6,0.7879999999999999,6.18,-2.72,69.1,14.0
100056,899,1813,0.496,677,1250,0.542,222,563,0.39399999999999996,514,695,0.74,365,837,1202,566,168,88,393,539,72.4,0.857,9.33,0.07,62.0,11.0
100057,880,1859,0.473,654,1286,0.509,226,573,0.39399999999999996,481,683,0.7040000000000001,353,808,1161,536,301,121,530,693,70.5,0.6859999999999999,-0.7,-5.23,65.4,15.0
100058,821,1736,0.473,580,1149,0.505,241,587,0.41100000000000003,398,545,0.73,321,784,1105,482,203,121,398,556,73.6,0.677,2.71,-4.01,64.7,14.0
100059,957,2105,0.455,728,1377,0.529,229,728,0.315,522,772,0.6759999999999999,485,831,1316,554,225,124,452,647,78.4,0.618,13.6,7.71,72.5,9.0
100060,944,2044,0.462,749,1454,0.515,195,590,0.331,574,810,0.7090000000000001,395,895,1290,429,287,131,477,622,78.1,0.6759999999999999,3.21,-1.87,70.1,16.0
100061,778,1618,0.48100000000000004,562,1042,0.539,216,576,0.375,434,619,0.701,266,758,1024,440,194,175,439,501,66.8,0.667,12.48,8.23,62.0,8.0
100062,786,1795,0.43799999999999994,609,1234,0.494,177,561,0.316,350,539,0.649,311,815,1126,421,200,100,384,582,65.6,0.75,1.1,-3.21,56.1,14.0
100063,885,2000,0.44299999999999995,668,1351,0.494,217,649,0.33399999999999996,541,733,0.738,485,774,1259,503,208,147,457,614,74.4,0.647,10.36,7.23,70.5,7.0
100064,820,1886,0.435,604,1255,0.48100000000000004,216,631,0.342,536,739,0.725,399,854,1253,423,284,202,548,657,68.3,0.7140000000000001,11.37,7.91,64.9,5.0
100065,861,1899,0.45299999999999996,544,1064,0.511,317,835,0.38,378,557,0.679,388,728,1116,503,245,93,453,553,73.2,0.6970000000000001,1.14,-3.16,68.5,13.0
100066,725,1778,0.408,584,1312,0.445,141,466,0.303,575,861,0.6679999999999999,422,864,1286,421,229,121,569,764,63.7,0.529,-8.29,-7.68,64.3,16.0
100067,993,2040,0.48700000000000004,738,1378,0.536,255,662,0.385,530,731,0.725,443,965,1408,508,237,242,491,639,77.0,0.778,17.97,8.03,65.6,3.0
100068,845,1911,0.442,585,1150,0.509,260,761,0.342,661,896,0.738,353,888,1241,464,267,86,456,685,68.7,0.868,14.37,5.08,59.4,5.0
100069,1025,2120,0.483,733,1420,0.516,292,700,0.41700000000000004,650,823,0.79,367,965,1332,567,307,126,417,621,83.1,0.833,18.82,3.0,66.4,7.0
100070,1033,2111,0.489,771,1463,0.527,262,648,0.40399999999999997,609,871,0.6990000000000001,468,989,1457,609,301,232,470,658,81.6,0.917,24.68,8.25,64.2,1.0
100071,981,2182,0.45,728,1479,0.49200000000000005,253,703,0.36,734,1098,0.6679999999999999,559,878,1437,541,274,187,529,828,79.7,0.784,19.88,10.28,69.8,2.0
100072,1066,2228,0.478,835,1531,0.545,231,697,0.331,649,971,0.6679999999999999,538,1046,1584,573,279,273,538,641,79.3,0.9209999999999999,21.13,6.82,64.9,1.0
100073,978,1961,0.499,752,1362,0.552,226,599,0.377,571,821,0.695,439,880,1319,556,347,196,527,618,76.5,0.861,8.69,-3.89,60.4,13.0
100074,887,2023,0.43799999999999994,614,1284,0.478,273,739,0.369,608,909,0.669,458,889,1347,497,232,120,387,615,75.9,0.857,12.49,3.84,67.2,3.0
100075,747,1741,0.429,514,1082,0.475,233,659,0.354,489,645,0.758,333,797,1130,367,198,70,372,556,63.3,0.857,12.03,4.27,55.1,9.0
100076,925,2153,0.43,647,1394,0.46399999999999997,278,759,0.366,635,883,0.7190000000000001,443,928,1371,524,278,97,473,696,74.7,0.595,4.56,-0.03,69.4,14.0
100077,922,2061,0.447,756,1538,0.49200000000000005,166,523,0.317,405,625,0.648,540,854,1394,554,282,105,457,560,67.1,0.75,11.39,1.78,57.5,11.0
100078,944,1950,0.484,660,1251,0.528,284,699,0.406,496,652,0.7609999999999999,370,874,1244,543,168,176,394,560,78.5,0.8240000000000001,13.38,2.2,66.4,10.0
100079,991,2174,0.456,773,1493,0.518,218,681,0.32,520,775,0.6709999999999999,441,912,1353,530,290,136,490,733,73.5,0.757,16.05,7.75,65.2,6.0
100080,899,1962,0.45799999999999996,647,1286,0.503,252,676,0.373,650,861,0.755,441,831,1272,448,259,133,452,731,81.8,0.758,16.72,7.75,72.8,2.0
100081,811,1869,0.434,677,1434,0.47200000000000003,134,435,0.308,501,762,0.657,463,843,1306,369,221,162,471,624,72.8,0.645,11.45,8.85,69.5,9.0
100082,1004,2212,0.45399999999999996,813,1644,0.495,191,568,0.336,652,905,0.72,476,888,1364,515,264,151,460,766,79.2,0.722,15.64,7.49,70.0,11.0
100083,966,2028,0.47600000000000003,738,1419,0.52,228,609,0.374,543,717,0.757,395,846,1241,500,198,86,421,593,77.2,0.6859999999999999,17.29,8.26,68.2,8.0
100084,913,1894,0.48200000000000004,587,1135,0.517,326,759,0.43,393,538,0.73,349,800,1149,543,243,122,414,598,76.4,0.853,8.76,-0.91,64.5,12.0
100085,1049,2375,0.442,748,1593,0.47,301,782,0.385,682,899,0.759,569,991,1560,555,266,162,429,722,77.0,0.875,25.21,9.21,61.0,1.0
100086,948,2064,0.45899999999999996,735,1477,0.498,213,587,0.363,512,779,0.657,464,966,1430,508,288,190,574,670,72.8,0.639,14.11,9.02,65.7,10.0
100087,912,1856,0.491,730,1340,0.545,182,516,0.353,608,916,0.664,358,928,1286,456,227,142,444,614,76.9,0.794,12.11,3.83,67.4,8.0
100088,966,2052,0.47100000000000003,771,1542,0.5,195,510,0.382,502,689,0.7290000000000001,421,849,1270,545,256,154,383,554,79.7,0.727,17.75,7.95,68.3,4.0
100089,974,2068,0.47100000000000003,787,1525,0.516,187,543,0.344,523,764,0.685,487,939,1426,606,242,123,514,666,71.8,0.757,15.33,8.17,63.8,5.0
100090,926,2104,0.44,668,1403,0.47600000000000003,258,701,0.368,517,714,0.7240000000000001,441,759,1200,522,371,160,432,656,77.3,0.6759999999999999,17.39,6.36,66.2,10.0
100091,983,1999,0.49200000000000005,707,1291,0.5479999999999999,276,708,0.39,498,716,0.696,325,909,1234,545,262,157,413,565,74.1,0.784,19.49,7.37,61.5,2.0
100092,809,1811,0.447,628,1285,0.489,181,526,0.344,537,775,0.693,420,849,1269,536,177,139,421,594,68.7,0.735,14.3,7.39,61.8,3.0
100093,867,1957,0.44299999999999995,680,1369,0.49700000000000005,187,588,0.318,546,755,0.723,351,819,1170,493,248,162,381,651,70.5,0.8290000000000001,17.52,8.81,61.3,4.0
100094,1042,2021,0.516,798,1397,0.5710000000000001,244,624,0.391,504,745,0.677,417,920,1337,673,336,221,532,515,80.9,0.857,21.72,7.21,66.4,1.0
100095,813,1846,0.44,603,1220,0.494,210,626,0.335,590,892,0.6609999999999999,400,852,1252,417,223,113,417,619,71.4,0.706,15.24,9.8,64.5,5.0
100096,942,2190,0.43,685,1428,0.48,257,762,0.337,611,868,0.7040000000000001,585,882,1467,589,213,155,451,686,72.4,0.816,19.16,10.26,63.5,2.0
100097,776,1750,0.44299999999999995,530,1060,0.5,246,690,0.35700000000000004,416,568,0.732,320,736,1056,412,187,113,289,537,67.1,0.727,17.84,7.66,56.9,4.0
100098,961,2082,0.462,711,1418,0.501,250,664,0.377,621,873,0.711,444,971,1415,494,235,132,452,662,79.8,0.743,16.23,5.94,69.5,6.0
100099,735,1934,0.38,611,1434,0.426,124,500,0.248,448,696,0.644,450,826,1276,346,283,135,402,622,61.9,0.5760000000000001,-8.68,-7.31,61.4,16.0
100100,909,1963,0.46299999999999997,622,1188,0.524,287,775,0.37,511,727,0.703,410,837,1247,673,257,85,442,661,79.3,0.758,3.71,-3.37,69.2,14.0
100101,891,1879,0.474,690,1293,0.534,201,586,0.34299999999999997,501,744,0.6729999999999999,323,870,1193,488,288,120,435,643,75.3,0.7879999999999999,12.66,1.96,64.6,12.0
100102,890,2006,0.444,687,1358,0.506,203,648,0.313,472,671,0.703,455,810,1265,479,243,94,423,501,72.2,0.618,11.89,7.16,66.4,10.0
100103,842,1853,0.45399999999999996,622,1302,0.478,220,551,0.39899999999999997,574,799,0.718,339,862,1201,495,203,85,429,589,75.1,0.667,-3.33,-7.79,70.6,16.0
100104,798,1748,0.457,619,1210,0.512,179,538,0.33299999999999996,662,921,0.7190000000000001,364,856,1220,394,144,94,485,590,73.8,0.727,-2.49,-4.72,69.8,15.0
100105,855,1978,0.43200000000000005,678,1403,0.483,177,575,0.308,537,815,0.659,445,832,1277,382,293,112,519,673,69.3,0.5710000000000001,-0.83,-1.47,67.5,16.0
100106,859,1829,0.47,656,1277,0.514,203,552,0.368,616,854,0.721,361,836,1197,436,188,171,448,632,76.9,0.727,15.24,7.86,68.9,4.0
100107,791,1636,0.483,581,1110,0.523,210,526,0.39899999999999997,436,603,0.723,283,765,1048,396,206,106,390,571,69.6,0.688,3.93,-2.35,61.3,14.0
100108,899,1950,0.461,668,1255,0.532,231,695,0.332,456,637,0.716,337,812,1149,551,266,117,395,691,73.1,0.735,12.57,4.82,63.8,8.0
100109,905,1815,0.499,693,1267,0.547,212,548,0.387,478,672,0.711,333,799,1132,524,237,161,473,579,73.5,0.6759999999999999,17.03,9.56,66.1,3.0
100110,918,1953,0.47,657,1280,0.513,261,673,0.38799999999999996,538,744,0.723,402,848,1250,585,194,104,362,530,75.3,0.657,13.14,6.22,68.4,6.0
100111,868,1943,0.447,618,1239,0.499,250,704,0.355,441,630,0.7,304,835,1139,442,289,158,384,634,69.3,0.743,10.03,3.43,62.7,7.0
100112,875,1846,0.474,696,1282,0.5429999999999999,179,564,0.317,460,741,0.621,444,813,1257,458,251,156,453,552,70.3,0.735,11.34,4.21,61.8,11.0
100113,815,1868,0.436,618,1322,0.467,197,546,0.361,572,859,0.6659999999999999,412,815,1227,433,267,80,520,757,68.5,0.657,-3.71,-6.15,65.9,15.0
100114,1005,2158,0.466,810,1592,0.509,195,566,0.345,556,878,0.633,503,922,1425,489,269,194,464,670,81.2,0.706,18.56,7.38,70.0,8.0
100115,861,1890,0.456,587,1226,0.479,274,664,0.413,489,660,0.741,343,728,1071,516,269,72,353,580,73.1,0.647,15.17,8.23,64.6,6.0
100116,876,1960,0.447,614,1183,0.519,262,777,0.337,491,700,0.701,478,739,1217,511,258,135,453,663,75.9,0.606,14.08,7.99,69.8,9.0
100117,851,1942,0.43799999999999994,647,1337,0.484,204,605,0.337,367,533,0.6890000000000001,377,904,1281,515,163,104,358,521,64.9,0.8290000000000001,12.44,4.27,56.8,5.0
100118,839,1861,0.451,565,1077,0.525,274,784,0.349,485,679,0.7140000000000001,327,842,1169,413,214,84,418,664,73.8,0.667,12.34,6.97,68.0,7.0
100119,783,1734,0.452,597,1177,0.507,186,557,0.33399999999999996,431,669,0.644,406,805,1211,446,267,200,528,575,68.2,0.688,14.64,6.79,60.4,9.0
100120,958,2282,0.42,668,1468,0.455,290,814,0.35600000000000004,545,768,0.71,440,745,1185,435,329,103,315,652,78.6,0.5429999999999999,6.74,3.48,75.0,13.0
100121,919,1997,0.46,632,1223,0.517,287,774,0.371,537,767,0.7,358,854,1212,484,203,111,437,595,78.3,0.647,2.06,1.66,77.6,12.0
100122,851,1878,0.45299999999999996,635,1247,0.509,216,631,0.342,432,654,0.6609999999999999,420,758,1178,453,301,151,480,564,73.4,0.6559999999999999,15.71,7.9,64.5,7.0
100123,674,1522,0.44299999999999995,469,978,0.48,205,544,0.377,475,698,0.6809999999999999,268,716,984,414,202,92,460,572,67.6,0.667,-0.13,-1.09,65.7,15.0
100124,920,2053,0.44799999999999995,714,1413,0.505,206,640,0.322,630,876,0.7190000000000001,477,867,1344,461,236,169,485,632,76.5,0.743,-0.64,-2.96,71.5,14.0
100125,930,2048,0.45399999999999996,770,1550,0.49700000000000005,160,498,0.321,534,793,0.6729999999999999,442,868,1310,486,298,119,418,471,75.1,0.794,8.48,-1.17,65.5,13.0
100126,826,1884,0.43799999999999994,660,1360,0.485,166,524,0.317,639,930,0.687,433,858,1291,423,239,141,487,635,70.2,0.7140000000000001,-1.26,-6.69,64.8,16.0
100127,941,1928,0.488,699,1343,0.52,242,585,0.414,435,574,0.758,362,876,1238,584,162,123,358,562,73.1,0.7709999999999999,13.62,1.23,59.9,12.0
100128,960,2239,0.429,755,1622,0.465,205,617,0.332,688,983,0.7,568,920,1488,461,243,152,499,782,76.0,0.73,-1.18,-6.15,70.4,15.0
100129,825,1873,0.44,622,1293,0.48100000000000004,203,580,0.35,555,830,0.669,402,841,1243,469,242,74,416,621,68.8,0.743,4.43,-2.57,61.0,13.0
100130,912,1949,0.46799999999999997,666,1332,0.5,246,617,0.39899999999999997,463,661,0.7,375,862,1237,583,273,199,427,579,72.4,0.6,15.64,7.32,64.1,11.0
100131,810,1827,0.44299999999999995,593,1197,0.495,217,630,0.344,493,703,0.701,384,793,1177,445,272,161,449,624,68.5,0.647,13.76,6.58,61.4,12.0
100132,881,1950,0.452,713,1435,0.49700000000000005,168,515,0.326,576,810,0.711,400,813,1213,492,310,152,506,664,73.7,0.588,-0.69,-2.89,68.6,16.0
100133,802,1871,0.429,568,1204,0.47200000000000003,234,667,0.35100000000000003,546,774,0.705,362,824,1186,430,240,76,461,657,70.1,0.588,-5.8,-4.93,69.5,16.0
100134,968,2228,0.434,629,1311,0.48,339,917,0.37,589,824,0.715,428,864,1292,583,328,140,452,735,71.6,0.7,8.56,3.78,66.8,11.0
100135,919,2122,0.433,630,1300,0.485,289,822,0.35200000000000004,580,799,0.726,431,906,1337,452,226,61,416,718,71.2,0.737,11.53,5.02,64.1,8.0
100136,1019,2267,0.449,707,1402,0.504,312,865,0.361,662,865,0.765,420,1005,1425,538,298,150,404,647,81.4,0.865,18.65,5.76,67.9,3.0
100137,848,1939,0.43700000000000006,628,1288,0.488,220,651,0.33799999999999997,496,742,0.6679999999999999,454,783,1237,497,258,129,401,605,68.9,0.743,15.41,6.1,59.6,6.0
100138,1053,2429,0.434,819,1718,0.47700000000000004,234,711,0.32899999999999996,627,822,0.763,570,1056,1626,534,259,228,466,646,72.4,0.78,17.95,10.44,64.9,3.0
100139,968,2083,0.465,735,1422,0.517,233,661,0.35200000000000004,498,744,0.669,467,917,1384,521,221,131,452,545,72.1,0.784,16.27,7.57,63.4,2.0
100140,932,1947,0.479,729,1399,0.521,203,548,0.37,617,810,0.762,398,916,1314,542,254,132,474,649,76.7,0.7140000000000001,13.86,4.01,65.9,11.0
100141,849,1939,0.43799999999999994,612,1308,0.46799999999999997,237,631,0.376,542,828,0.655,490,790,1280,474,208,154,498,692,72.9,0.6759999999999999,14.59,8.41,66.1,5.0
100142,1002,2183,0.45899999999999996,721,1476,0.488,281,707,0.397,560,789,0.71,445,975,1420,482,211,239,406,601,74.9,0.763,20.3,8.91,63.5,4.0
100143,851,1874,0.45399999999999996,647,1273,0.508,204,601,0.33899999999999997,506,751,0.674,484,827,1311,424,300,110,525,653,68.9,0.7140000000000001,2.81,-3.13,61.8,13.0
100144,886,1866,0.475,684,1354,0.505,202,512,0.395,540,805,0.6709999999999999,484,875,1359,595,160,111,397,610,73.9,0.8240000000000001,20.82,7.85,61.0,1.0
100145,922,2007,0.45899999999999996,635,1272,0.499,287,735,0.39,446,649,0.687,344,878,1222,548,220,155,383,587,69.6,0.784,11.23,2.79,61.2,12.0
100146,991,2141,0.46299999999999997,768,1502,0.511,223,639,0.349,455,653,0.6970000000000001,472,924,1396,499,227,170,402,542,71.9,0.919,17.96,6.36,59.2,2.0
100147,868,1943,0.447,662,1360,0.48700000000000004,206,583,0.353,458,656,0.698,374,844,1218,511,231,156,368,538,70.6,0.765,12.35,4.23,62.5,7.0
100148,830,1824,0.455,657,1295,0.507,173,529,0.327,549,808,0.679,405,860,1265,493,186,198,502,594,70.1,0.6759999999999999,11.7,7.93,66.3,7.0
100149,783,1826,0.429,577,1215,0.475,206,611,0.337,531,747,0.711,469,758,1227,491,154,136,397,598,69.8,0.636,16.15,11.03,64.7,5.0
100150,798,1808,0.441,520,1064,0.489,278,744,0.374,436,533,0.818,355,733,1088,442,121,105,258,522,67.9,0.735,18.77,9.42,58.6,4.0
100151,969,2064,0.469,673,1319,0.51,296,745,0.397,671,899,0.746,408,911,1319,536,197,98,484,707,76.4,0.789,16.54,7.99,67.9,5.0
100152,1040,2206,0.47100000000000003,749,1428,0.525,291,778,0.374,622,826,0.753,446,953,1399,529,269,162,447,657,80.9,0.865,24.51,8.32,64.7,1.0
100153,827,1903,0.435,615,1269,0.485,212,634,0.33399999999999996,482,725,0.665,422,910,1332,423,288,203,541,651,69.1,0.6759999999999999,13.48,6.45,62.0,10.0
100154,876,1861,0.47100000000000003,649,1287,0.504,227,574,0.395,495,718,0.6890000000000001,364,824,1188,483,224,110,376,581,72.8,0.794,11.66,1.37,62.5,8.0
100155,894,1910,0.46799999999999997,662,1310,0.505,232,600,0.387,393,539,0.7290000000000001,342,836,1178,568,188,152,434,597,71.0,0.588,16.72,11.11,65.4,9.0
100156,1114,2193,0.508,843,1483,0.568,271,710,0.382,585,862,0.679,449,1026,1475,674,295,153,507,666,81.2,0.9209999999999999,24.1,7.62,64.7,1.0
100157,973,2094,0.465,782,1547,0.505,191,547,0.349,645,927,0.696,457,872,1329,574,265,134,455,622,75.2,0.595,14.89,8.51,68.8,11.0
100158,847,1889,0.44799999999999995,564,1085,0.52,283,804,0.35200000000000004,351,502,0.6990000000000001,289,826,1115,480,168,69,351,587,66.5,0.6,14.21,10.68,62.5,8.0
100159,1044,2317,0.451,854,1738,0.491,190,579,0.32799999999999996,590,878,0.672,525,1053,1578,573,232,204,493,597,77.5,0.784,18.87,10.15,68.8,2.0
100160,843,1832,0.46,570,1124,0.507,273,708,0.386,599,827,0.7240000000000001,371,890,1261,563,156,128,364,517,75.2,0.794,18.17,8.43,65.5,2.0
100161,1017,2059,0.494,732,1385,0.529,285,674,0.423,535,763,0.701,419,858,1277,587,263,118,375,519,77.1,0.919,25.84,8.38,59.7,1.0
100162,875,1957,0.447,640,1312,0.488,235,645,0.364,481,673,0.715,380,827,1207,538,211,141,354,605,72.5,0.765,19.36,8.69,61.9,3.0
100163,936,1983,0.47200000000000003,714,1355,0.527,222,628,0.354,474,713,0.665,429,879,1308,566,304,231,433,544,73.4,0.7709999999999999,18.85,8.79,63.3,3.0
100164,954,2099,0.455,753,1564,0.48100000000000004,201,535,0.376,592,905,0.654,494,958,1452,485,207,183,425,616,75.0,0.778,20.82,7.96,62.2,4.0
100165,1061,2260,0.469,756,1439,0.525,305,821,0.371,480,712,0.674,488,879,1367,593,234,179,426,718,83.1,0.6859999999999999,20.12,7.74,70.7,7.0
100166,756,1725,0.43799999999999994,517,1027,0.503,239,698,0.342,368,513,0.7170000000000001,352,757,1109,420,164,97,387,514,68.4,0.71,8.55,2.78,62.6,12.0
100167,825,1938,0.426,583,1323,0.441,242,615,0.39299999999999996,565,819,0.69,377,827,1204,433,212,89,428,740,68.3,0.528,-4.32,-2.97,67.4,16.0
100168,728,1841,0.395,563,1258,0.44799999999999995,165,583,0.28300000000000003,525,870,0.603,460,811,1271,404,255,163,551,777,61.3,0.486,-13.37,-10.31,63.8,16.0
100169,813,1832,0.444,609,1255,0.485,204,577,0.354,422,648,0.6509999999999999,340,813,1153,402,199,104,390,589,66.2,0.5589999999999999,11.52,7.97,62.7,11.0
100170,803,1828,0.439,637,1323,0.48100000000000004,166,505,0.32899999999999996,459,687,0.6679999999999999,524,831,1355,485,234,146,424,503,65.6,0.794,9.03,1.76,58.4,9.0
100171,883,1853,0.47700000000000004,686,1360,0.504,197,493,0.4,539,778,0.693,372,736,1108,487,227,86,404,654,73.6,0.618,4.35,-1.21,68.0,14.0
100172,983,2145,0.45799999999999996,738,1476,0.5,245,669,0.366,537,727,0.7390000000000001,425,772,1197,558,329,171,431,689,80.8,0.6759999999999999,14.77,6.5,71.6,11.0
100173,827,1855,0.446,593,1270,0.467,234,585,0.4,499,633,0.7879999999999999,270,879,1149,491,160,106,380,612,70.2,0.735,2.39,-3.87,63.9,14.0
100174,742,1636,0.45399999999999996,515,1025,0.502,227,611,0.37200000000000005,459,610,0.752,277,761,1038,457,233,133,456,611,67.8,0.563,1.22,0.12,65.8,15.0
100175,807,1773,0.455,664,1346,0.493,143,427,0.335,556,783,0.71,354,714,1068,417,266,94,408,626,70.1,0.636,13.1,10.01,67.0,6.0
100176,840,1788,0.47,634,1226,0.517,206,562,0.36700000000000005,563,764,0.737,363,903,1266,500,162,110,402,591,72.0,0.882,13.23,0.5,58.7,12.0
100177,788,1696,0.465,595,1165,0.511,193,531,0.363,446,609,0.732,315,790,1105,427,191,134,389,551,69.2,0.7809999999999999,3.71,-1.61,63.0,13.0
100178,949,2097,0.45299999999999996,640,1243,0.515,309,854,0.36200000000000004,416,627,0.6629999999999999,434,838,1272,608,327,175,459,671,74.9,0.7140000000000001,18.6,8.2,64.5,4.0
100179,848,1853,0.45799999999999996,585,1145,0.511,263,708,0.371,622,837,0.743,370,885,1255,454,175,162,441,552,75.9,0.6759999999999999,15.1,6.86,67.7,5.0
100180,731,1708,0.428,477,1051,0.45399999999999996,254,657,0.387,571,742,0.77,376,774,1150,371,191,62,454,609,71.5,0.6559999999999999,1.39,-2.24,65.8,15.0
100181,767,1748,0.439,551,1110,0.496,216,638,0.33899999999999997,394,544,0.7240000000000001,337,731,1068,413,151,82,358,530,63.1,0.5589999999999999,11.98,11.45,62.5,10.0
100182,817,1894,0.431,597,1274,0.469,220,620,0.355,484,691,0.7,407,849,1256,509,219,167,454,648,68.8,0.5589999999999999,13.7,11.67,66.6,10.0
100183,944,2045,0.462,617,1181,0.522,327,864,0.37799999999999995,575,781,0.736,451,807,1258,575,338,118,480,729,79.7,0.857,13.07,-4.42,62.2,13.0
100184,891,1975,0.451,681,1336,0.51,210,639,0.32899999999999996,532,782,0.68,421,825,1246,512,297,183,535,712,72.1,0.7140000000000001,6.91,3.14,68.3,12.0
100185,746,1843,0.405,533,1185,0.45,213,658,0.324,492,759,0.648,367,803,1170,387,241,185,412,604,66.6,0.727,-5.2,-8.77,62.7,16.0
100186,758,1719,0.441,577,1185,0.48700000000000004,181,534,0.33899999999999997,557,799,0.6970000000000001,412,781,1193,444,215,51,426,602,68.3,0.727,12.62,5.94,60.9,7.0
100187,796,1819,0.43799999999999994,586,1215,0.48200000000000004,210,604,0.348,582,769,0.757,402,821,1223,450,208,125,392,578,72.2,0.636,15.05,8.23,65.4,9.0
100188,842,1836,0.45899999999999996,658,1278,0.515,184,558,0.33,495,718,0.6890000000000001,368,783,1151,509,268,124,414,635,71.6,0.727,14.67,6.0,62.9,8.0
100189,749,1865,0.402,484,1118,0.433,265,747,0.355,507,695,0.7290000000000001,414,835,1249,345,189,129,418,635,64.9,0.6,-2.48,-3.85,63.5,16.0
100190,784,1700,0.461,611,1174,0.52,173,526,0.32899999999999996,565,756,0.747,328,802,1130,424,174,98,386,551,72.1,0.75,11.88,4.41,64.6,6.0
100191,837,1941,0.431,662,1358,0.48700000000000004,175,583,0.3,527,770,0.684,464,815,1279,443,250,126,454,662,69.9,0.5589999999999999,11.08,8.73,67.5,9.0
100192,928,2009,0.462,699,1374,0.509,229,635,0.361,645,999,0.6459999999999999,479,899,1378,503,246,111,505,580,82.7,0.818,2.23,-5.77,74.7,15.0
100193,892,2073,0.43,609,1288,0.473,283,785,0.361,457,649,0.7040000000000001,363,875,1238,520,240,129,432,692,70.1,0.639,2.15,-1.02,65.7,15.0
100194,713,1782,0.4,516,1209,0.42700000000000005,197,573,0.344,446,693,0.644,384,825,1209,383,263,154,511,662,60.9,0.588,-0.28,-1.08,60.1,14.0
100195,769,1793,0.429,534,1144,0.467,235,649,0.36200000000000004,480,676,0.71,352,820,1172,431,212,145,477,684,66.3,0.588,3.41,2.9,64.5,14.0
100196,1052,2137,0.49200000000000005,765,1370,0.5579999999999999,287,767,0.374,601,834,0.721,451,915,1366,568,216,192,473,644,85.5,0.7140000000000001,8.28,0.1,76.9,13.0
100197,809,1703,0.475,586,1072,0.547,223,631,0.353,417,568,0.7340000000000001,324,757,1081,481,193,139,433,603,70.6,0.6559999999999999,14.61,10.39,66.3,6.0
100198,823,1822,0.452,667,1366,0.488,156,456,0.342,465,667,0.6970000000000001,407,836,1243,495,211,162,444,541,68.7,0.636,10.43,6.13,64.4,10.0
100199,977,2099,0.465,744,1420,0.524,233,679,0.34299999999999997,540,771,0.7,381,842,1223,599,296,154,473,637,77.9,0.743,11.25,1.55,67.4,14.0
100200,769,1952,0.39399999999999996,574,1314,0.43700000000000006,195,638,0.306,539,785,0.687,449,724,1173,385,195,146,534,691,64.9,0.457,-2.66,0.51,68.1,16.0
100201,772,1765,0.43700000000000006,603,1231,0.49,169,534,0.316,421,597,0.705,374,741,1115,423,200,137,485,552,59.3,0.611,9.2,7.29,56.6,12.0
100202,848,1914,0.44299999999999995,657,1353,0.486,191,561,0.34,528,714,0.7390000000000001,401,765,1166,475,221,86,445,627,67.1,0.667,0.98,-5.19,60.9,16.0
100203,1004,2148,0.467,745,1472,0.506,259,676,0.38299999999999995,572,759,0.754,470,810,1280,570,286,178,522,674,74.7,0.789,16.54,8.03,65.3,3.0
100204,835,1874,0.446,636,1302,0.488,199,572,0.348,560,810,0.691,351,841,1192,422,210,117,468,614,67.5,0.667,7.91,5.73,63.0,11.0
100205,823,1740,0.473,608,1173,0.518,215,567,0.379,575,803,0.716,359,736,1095,455,223,105,433,514,73.8,0.7879999999999999,13.86,3.25,63.2,7.0
100206,949,1928,0.49200000000000005,720,1397,0.515,229,531,0.431,655,858,0.763,383,747,1130,487,233,115,463,632,77.3,0.75,18.63,7.8,66.4,4.0
100207,847,1888,0.449,554,1102,0.503,293,786,0.373,503,731,0.688,371,802,1173,484,196,96,419,547,73.2,0.6759999999999999,13.32,7.32,67.2,8.0
100208,812,1849,0.439,629,1303,0.483,183,546,0.335,536,799,0.6709999999999999,471,658,1129,468,200,156,474,662,71.0,0.667,14.47,7.53,64.1,8.0
100209,1096,2248,0.488,871,1653,0.527,225,595,0.37799999999999995,678,938,0.723,472,973,1445,531,242,344,445,593,77.4,0.95,24.73,7.93,60.6,1.0
100210,963,2281,0.42200000000000004,730,1548,0.47200000000000003,233,733,0.318,568,826,0.688,518,905,1423,532,353,193,562,706,68.2,0.75,16.19,9.02,61.0,4.0
100211,919,2033,0.452,718,1437,0.5,201,596,0.337,599,831,0.721,414,735,1149,580,304,122,461,620,75.4,0.7709999999999999,16.92,7.5,65.9,3.0
100212,811,1732,0.46799999999999997,572,1128,0.507,239,604,0.396,551,761,0.7240000000000001,360,659,1019,418,276,139,458,592,73.1,0.9390000000000001,8.74,-2.6,60.6,6.0
100213,876,1898,0.462,612,1199,0.51,264,699,0.37799999999999995,529,748,0.7070000000000001,395,821,1216,573,240,117,467,609,72.7,0.8,15.6,3.34,59.3,5.0
100214,1057,2219,0.47600000000000003,858,1623,0.529,199,596,0.33399999999999996,600,846,0.7090000000000001,447,898,1345,568,281,125,449,630,74.7,0.795,23.95,9.07,59.8,2.0
100215,1006,2156,0.467,773,1488,0.519,233,668,0.349,495,709,0.698,459,722,1181,564,338,255,389,574,74.1,0.919,21.12,8.02,61.0,1.0
100216,837,2040,0.41,570,1240,0.46,267,800,0.33399999999999996,507,740,0.685,439,676,1115,433,379,131,411,646,68.0,0.8059999999999999,8.79,0.63,59.8,12.0
100217,885,1921,0.461,578,1129,0.512,307,792,0.38799999999999996,538,770,0.6990000000000001,361,764,1125,458,214,144,465,580,72.6,0.6940000000000001,15.71,8.04,65.0,5.0
100218,797,1875,0.425,512,1100,0.465,285,775,0.368,425,575,0.7390000000000001,349,763,1112,428,181,126,320,512,64.0,0.722,19.04,8.24,53.2,4.0
100219,924,2194,0.42100000000000004,664,1431,0.46399999999999997,260,763,0.341,414,643,0.644,489,736,1225,479,298,170,403,570,68.2,0.703,12.93,6.28,61.5,6.0
100220,975,1935,0.504,688,1258,0.547,287,677,0.424,535,737,0.726,330,833,1163,616,169,82,421,592,79.2,0.8290000000000001,12.92,3.41,69.7,8.0
100221,976,2106,0.46299999999999997,619,1167,0.53,357,939,0.38,499,700,0.713,416,764,1180,551,233,124,410,575,75.9,0.703,18.25,7.33,65.0,7.0
100222,877,1923,0.456,661,1312,0.504,216,611,0.354,473,669,0.7070000000000001,398,771,1169,427,265,213,550,653,69.8,0.7140000000000001,14.53,7.62,62.9,3.0
100223,811,1743,0.465,625,1207,0.518,186,536,0.34700000000000003,470,673,0.698,367,741,1108,451,200,156,417,578,69.0,0.727,16.81,7.69,59.4,3.0
100224,1023,2169,0.47200000000000003,801,1526,0.525,222,643,0.345,597,863,0.6920000000000001,449,919,1368,587,285,222,506,678,73.5,0.821,21.72,9.93,61.7,2.0
100225,902,2030,0.444,648,1304,0.49700000000000005,254,726,0.35,590,768,0.768,386,718,1104,456,269,106,391,629,75.7,0.7709999999999999,4.27,-5.14,65.4,15.0
100226,960,2012,0.47700000000000004,760,1457,0.522,200,555,0.36,531,759,0.7,420,882,1302,566,265,157,474,650,71.6,0.784,21.32,9.82,59.3,1.0
100227,977,2134,0.45799999999999996,779,1577,0.494,198,557,0.355,545,774,0.7040000000000001,456,825,1281,577,249,150,470,623,72.9,0.649,12.1,6.8,67.6,11.0
100228,870,1977,0.44,672,1342,0.501,198,635,0.312,544,829,0.6559999999999999,421,765,1186,431,240,169,539,702,68.9,0.722,-3.68,-5.39,67.1,15.0
100229,1134,2473,0.45899999999999996,940,1893,0.49700000000000005,194,580,0.33399999999999996,629,922,0.682,570,1022,1592,659,259,219,447,551,81.3,0.8420000000000001,21.34,7.07,67.1,1.0
100230,901,2107,0.428,623,1298,0.48,278,809,0.344,517,749,0.69,451,685,1136,488,347,103,481,723,70.2,0.784,7.17,0.17,62.5,13.0
100231,889,2019,0.44,605,1266,0.478,284,753,0.377,452,689,0.6559999999999999,391,648,1039,470,226,110,306,620,71.8,0.629,13.88,8.05,66.0,10.0
100232,814,1813,0.449,576,1150,0.501,238,663,0.359,470,653,0.72,346,648,994,459,236,99,382,569,68.7,0.765,15.15,4.06,57.6,9.0
100233,899,1986,0.45299999999999996,723,1485,0.48700000000000004,176,501,0.35100000000000003,569,819,0.695,378,805,1183,471,216,135,448,665,70.6,0.639,9.59,6.22,67.3,10.0
100234,1021,2033,0.502,767,1377,0.557,254,656,0.387,440,617,0.713,353,689,1042,638,241,71,414,559,82.9,0.758,8.36,-1.82,72.7,14.0
100235,812,2025,0.401,560,1248,0.449,252,777,0.324,456,708,0.644,460,696,1156,451,300,87,511,698,68.6,0.618,-8.03,-7.65,69.0,16.0
100236,893,1878,0.47600000000000003,737,1448,0.509,156,430,0.363,477,641,0.7440000000000001,341,754,1095,540,159,106,411,489,71.1,0.706,13.79,4.53,61.9,12.0
100237,902,2087,0.43200000000000005,749,1633,0.45899999999999996,153,454,0.337,616,855,0.72,497,791,1288,448,283,154,418,604,73.5,0.657,2.41,-3.77,65.6,16.0
100238,918,1963,0.46799999999999997,634,1235,0.513,284,728,0.39,569,783,0.727,363,715,1078,500,236,65,370,567,76.8,0.7709999999999999,7.34,-1.87,66.5,14.0
100239,942,2062,0.457,651,1263,0.515,291,799,0.364,496,734,0.6759999999999999,408,819,1227,616,299,169,466,604,76.3,0.743,13.55,4.37,65.9,6.0
100240,838,1914,0.43799999999999994,664,1331,0.499,174,583,0.298,496,739,0.6709999999999999,493,642,1135,477,210,85,422,555,71.1,0.5760000000000001,12.13,7.53,66.5,10.0
100241,970,2045,0.474,805,1540,0.523,165,505,0.327,707,1058,0.6679999999999999,518,834,1352,498,244,154,533,630,78.1,0.722,8.73,0.08,68.3,13.0
100242,858,1900,0.452,673,1343,0.501,185,557,0.332,435,657,0.662,415,736,1151,457,199,233,418,492,68.7,0.588,12.27,8.07,64.5,9.0
100243,819,1975,0.415,604,1374,0.44,215,601,0.358,573,779,0.736,471,662,1133,374,205,98,377,651,71.4,0.735,7.79,3.61,65.1,9.0
100244,879,1969,0.446,624,1209,0.516,255,760,0.336,558,731,0.763,415,752,1167,455,184,116,388,673,77.9,0.758,7.26,-1.68,67.8,13.0
100245,764,1621,0.47100000000000003,575,1148,0.501,189,473,0.4,526,685,0.768,266,673,939,389,172,60,408,606,70.1,0.625,6.58,5.23,68.0,11.0
100246,880,1880,0.46799999999999997,659,1262,0.522,221,618,0.358,529,790,0.67,391,750,1141,476,242,92,440,527,73.8,0.735,9.52,0.87,64.0,12.0
100247,755,1775,0.425,591,1291,0.45799999999999996,164,484,0.33899999999999997,548,762,0.7190000000000001,430,614,1044,393,255,147,443,628,67.3,0.727,0.37,-2.72,64.2,15.0
100248,920,1907,0.48200000000000004,697,1278,0.545,223,629,0.355,682,893,0.764,377,716,1093,566,283,88,456,612,80.7,0.706,3.06,-2.72,71.4,16.0
100249,912,1892,0.48200000000000004,682,1272,0.536,230,620,0.371,491,656,0.748,359,798,1157,485,209,130,403,553,77.1,0.818,17.42,3.8,62.4,5.0
100250,695,1490,0.466,510,972,0.525,185,518,0.35700000000000004,458,613,0.747,262,661,923,401,184,137,379,473,65.6,0.8390000000000001,7.84,-1.56,55.6,12.0
100251,781,1689,0.462,586,1165,0.503,195,524,0.37200000000000005,482,672,0.7170000000000001,286,663,949,436,229,115,401,585,70.0,0.7809999999999999,4.55,-3.39,62.0,13.0
100252,836,1927,0.434,639,1326,0.48200000000000004,197,601,0.32799999999999996,601,820,0.733,453,665,1118,419,231,125,426,659,72.6,0.588,14.0,8.12,66.8,11.0
100253,778,1722,0.452,642,1252,0.513,136,470,0.289,443,623,0.711,352,714,1066,402,239,137,423,607,64.7,0.636,13.76,7.18,58.1,9.0
100254,721,1576,0.457,566,1107,0.511,155,469,0.33,403,558,0.722,253,691,944,394,207,88,367,506,62.5,0.688,12.51,4.23,54.2,10.0
100255,770,1687,0.456,596,1183,0.504,174,504,0.345,540,710,0.7609999999999999,352,686,1038,444,186,133,439,592,70.4,0.625,8.25,2.84,65.0,14.0
100256,975,2026,0.48100000000000004,666,1209,0.551,309,817,0.37799999999999995,572,779,0.7340000000000001,401,750,1151,606,255,78,430,631,80.9,0.7709999999999999,11.81,-1.22,67.5,14.0
100257,903,2008,0.45,738,1455,0.507,165,553,0.298,626,857,0.73,434,690,1124,463,272,165,450,684,72.1,0.611,2.4,-0.01,67.6,15.0
100258,874,1915,0.456,600,1176,0.51,274,739,0.371,606,864,0.701,406,746,1152,423,210,136,415,626,77.3,0.794,17.05,8.4,68.6,2.0
100259,920,1940,0.474,695,1334,0.521,225,606,0.371,704,965,0.73,396,771,1167,500,206,113,546,531,81.4,0.735,-1.34,-5.1,77.7,16.0
100260,863,1903,0.45299999999999996,666,1325,0.503,197,578,0.341,493,703,0.701,360,793,1153,417,189,79,426,543,71.1,0.765,9.04,3.79,63.7,6.0
100261,981,1945,0.504,688,1208,0.57,293,737,0.39799999999999996,559,730,0.7659999999999999,319,706,1025,566,285,97,358,499,80.4,0.857,19.77,5.68,66.3,2.0
100262,808,1777,0.455,532,989,0.5379999999999999,276,788,0.35,363,503,0.722,291,676,967,431,168,72,370,530,66.3,0.706,13.19,8.98,61.5,4.0
100263,857,1811,0.473,612,1098,0.557,245,713,0.344,508,697,0.7290000000000001,378,774,1152,520,227,102,383,527,74.8,0.818,11.26,0.78,62.7,7.0
100264,861,1836,0.469,633,1262,0.502,228,574,0.397,451,627,0.7190000000000001,333,686,1019,493,230,134,401,567,75.0,0.75,10.44,4.94,69.5,5.0
100265,933,1899,0.491,748,1388,0.539,185,511,0.36200000000000004,563,785,0.7170000000000001,332,761,1093,505,278,196,444,665,74.7,0.743,16.86,5.26,63.1,8.0
100266,781,1800,0.434,560,1135,0.493,221,665,0.332,474,673,0.7040000000000001,345,705,1050,497,177,114,342,470,66.4,0.647,11.18,6.47,61.7,7.0
100267,776,1927,0.40299999999999997,561,1220,0.46,215,707,0.304,532,809,0.6579999999999999,387,779,1166,405,261,165,564,716,62.1,0.541,-6.94,-6.3,61.9,16.0
100268,910,1939,0.469,637,1211,0.526,273,728,0.375,517,713,0.725,422,777,1199,502,214,98,416,612,74.6,0.8,14.51,3.31,62.9,11.0
100269,818,1941,0.42100000000000004,607,1313,0.462,211,628,0.336,499,714,0.6990000000000001,365,699,1064,423,272,166,401,620,65.2,0.583,-1.73,-2.28,64.6,16.0
100270,871,1931,0.451,609,1236,0.493,262,695,0.377,446,605,0.737,332,626,958,481,263,119,390,520,72.1,0.706,10.14,4.46,66.4,13.0
100271,880,1933,0.455,611,1208,0.506,269,725,0.371,541,722,0.7490000000000001,393,779,1172,476,234,134,458,584,73.4,0.7709999999999999,17.3,7.47,63.6,6.0
100272,869,1931,0.45,630,1243,0.507,239,688,0.34700000000000003,518,744,0.696,419,794,1213,465,206,94,474,644,69.3,0.75,10.99,6.08,63.9,6.0
100273,833,1875,0.444,699,1432,0.488,134,443,0.302,418,585,0.715,361,773,1134,468,192,154,417,549,67.2,0.636,10.65,7.77,64.3,12.0
100274,881,1961,0.449,701,1429,0.491,180,532,0.33799999999999997,611,855,0.715,493,804,1297,445,162,74,389,600,72.9,0.743,13.65,5.89,63.7,8.0
100275,961,1934,0.49700000000000005,735,1325,0.555,226,609,0.371,548,777,0.705,409,786,1195,530,277,96,393,551,77.0,0.914,20.47,4.18,59.9,1.0
100276,677,1425,0.475,486,945,0.514,191,480,0.39799999999999996,504,697,0.723,219,577,796,392,218,126,399,457,68.3,0.667,3.95,0.16,64.1,14.0
100277,1048,2300,0.456,818,1609,0.508,230,691,0.33299999999999996,652,920,0.7090000000000001,531,854,1385,584,430,168,495,727,74.5,0.875,24.81,9.13,58.8,1.0
100278,842,1844,0.457,695,1347,0.516,147,497,0.29600000000000004,551,755,0.73,418,698,1116,483,231,123,471,590,68.1,0.743,14.04,8.58,62.6,3.0
100279,976,2071,0.47100000000000003,756,1479,0.511,220,592,0.37200000000000005,509,771,0.66,438,805,1243,605,321,231,523,651,74.5,0.861,12.26,2.7,64.9,6.0
100280,1093,2260,0.484,797,1491,0.535,296,769,0.385,450,642,0.701,416,830,1246,565,239,108,368,496,75.2,0.795,21.28,10.05,63.3,4.0
100281,882,1921,0.45899999999999996,705,1398,0.504,177,523,0.33799999999999997,507,710,0.7140000000000001,421,820,1241,474,289,140,489,579,68.0,0.75,18.64,10.55,59.1,3.0
100282,944,2110,0.447,752,1533,0.491,192,577,0.33299999999999996,570,809,0.705,451,834,1285,484,314,146,555,651,71.6,0.757,13.82,5.77,63.6,12.0
100283,808,1812,0.446,598,1195,0.5,210,617,0.34,562,798,0.7040000000000001,306,726,1032,453,267,109,383,603,68.2,0.8,14.33,4.28,58.2,4.0
100284,1007,2293,0.439,774,1597,0.485,233,696,0.335,569,843,0.675,560,820,1380,562,360,248,495,637,70.4,0.75,20.3,8.57,58.7,4.0
100285,1010,2243,0.45,729,1443,0.505,281,800,0.35100000000000003,469,669,0.701,479,676,1155,521,422,109,407,708,76.9,0.75,16.89,4.47,64.5,5.0
100286,954,2166,0.44,695,1401,0.496,259,765,0.33899999999999997,553,791,0.6990000000000001,512,843,1355,530,289,173,492,700,69.7,0.769,14.68,6.09,61.2,9.0
100287,942,1882,0.501,635,1140,0.557,307,742,0.414,489,644,0.759,300,872,1172,609,174,92,443,588,74.4,0.778,16.44,5.16,63.2,7.0
100288,960,2033,0.47200000000000003,690,1357,0.508,270,676,0.39899999999999997,588,796,0.7390000000000001,337,782,1119,515,232,135,383,645,77.2,0.833,21.43,9.54,65.3,2.0
100289,976,2112,0.462,729,1390,0.524,247,722,0.342,497,736,0.675,412,814,1226,523,331,139,545,649,72.9,0.703,2.76,-2.07,66.7,15.0
100290,960,2010,0.478,660,1216,0.5429999999999999,300,794,0.37799999999999995,422,623,0.677,381,798,1179,540,265,120,401,518,71.4,0.784,23.86,6.83,54.4,3.0
100291,858,2084,0.41200000000000003,578,1211,0.47700000000000004,280,873,0.321,469,646,0.726,427,671,1098,365,245,142,411,648,68.5,0.639,13.23,10.08,64.8,7.0
100292,951,1971,0.48200000000000004,694,1334,0.52,257,637,0.40299999999999997,672,904,0.743,439,831,1270,514,256,130,469,598,78.6,0.8059999999999999,24.9,8.38,62.1,1.0
100293,962,2111,0.456,616,1187,0.519,346,924,0.374,509,696,0.731,422,816,1238,560,223,97,460,593,79.4,0.657,14.5,6.13,71.0,10.0
100294,985,2049,0.48100000000000004,769,1455,0.529,216,594,0.364,596,809,0.737,399,955,1354,575,260,247,517,620,75.2,0.838,20.79,7.54,61.9,1.0
100295,895,1968,0.455,641,1267,0.506,254,701,0.36200000000000004,465,680,0.684,357,822,1179,408,223,159,377,525,69.7,0.8059999999999999,16.99,7.88,60.6,2.0
100296,815,1838,0.44299999999999995,631,1292,0.488,184,546,0.337,523,764,0.685,501,685,1186,503,253,187,467,605,68.7,0.618,16.83,10.31,62.2,11.0
100297,977,2230,0.43799999999999994,739,1495,0.494,238,735,0.324,587,866,0.6779999999999999,466,785,1251,450,297,185,395,606,77.2,0.75,14.42,4.14,66.9,12.0
100298,1023,2321,0.441,751,1598,0.47,272,723,0.376,442,655,0.675,478,776,1254,616,303,117,433,539,76.7,0.6940000000000001,14.52,8.01,69.2,8.0
100299,928,2057,0.451,701,1419,0.494,227,638,0.35600000000000004,516,729,0.708,378,841,1219,493,248,162,377,590,70.2,0.784,20.19,9.32,59.4,2.0
100300,839,1916,0.43799999999999994,637,1298,0.491,202,618,0.327,476,697,0.6829999999999999,376,768,1144,425,235,155,410,497,69.3,0.6759999999999999,13.01,6.19,61.1,7.0
100301,851,1986,0.428,608,1246,0.488,243,740,0.32799999999999996,511,707,0.723,381,676,1057,497,267,126,366,558,72.2,0.706,9.52,5.2,67.9,9.0
100302,838,1954,0.429,587,1285,0.457,251,669,0.375,562,770,0.73,367,797,1164,443,197,105,478,685,69.1,0.41700000000000004,-9.13,-5.8,70.0,16.0
100303,848,1835,0.462,667,1355,0.49200000000000005,181,480,0.377,528,759,0.696,407,740,1147,481,238,128,464,700,70.7,0.8240000000000001,11.16,-1.52,58.1,11.0
100304,915,1909,0.479,669,1262,0.53,246,647,0.38,601,870,0.691,404,679,1083,515,232,117,486,597,78.7,0.588,-3.21,-5.8,76.1,16.0
100305,824,1790,0.46,575,1153,0.499,249,637,0.391,446,597,0.747,323,665,988,423,212,54,385,599,73.2,0.6559999999999999,9.44,5.27,65.5,13.0
100306,906,1844,0.491,627,1115,0.562,279,729,0.38299999999999995,442,604,0.732,306,660,966,516,322,88,440,604,76.8,0.7879999999999999,10.37,-0.96,64.5,11.0
100307,818,1807,0.45299999999999996,661,1369,0.483,157,438,0.358,484,652,0.742,308,834,1142,455,118,139,321,498,67.0,0.8240000000000001,6.95,-1.96,57.8,11.0
100308,872,2002,0.436,645,1313,0.491,227,689,0.32899999999999996,525,747,0.703,418,863,1281,562,253,203,487,593,71.4,0.7140000000000001,12.92,5.71,63.0,5.0
100309,924,2015,0.45899999999999996,709,1380,0.514,215,635,0.33899999999999997,525,706,0.7440000000000001,454,812,1266,472,229,119,442,567,76.1,0.6759999999999999,15.41,6.0,66.7,9.0
100310,761,1757,0.433,535,1138,0.47,226,619,0.365,475,689,0.6890000000000001,288,747,1035,376,244,134,359,562,67.4,0.6970000000000001,-2.61,-10.31,57.3,16.0
100311,768,1815,0.423,547,1186,0.461,221,629,0.35100000000000003,598,829,0.721,335,788,1123,505,220,134,402,542,67.3,0.8290000000000001,13.28,6.63,60.6,3.0
100312,837,1813,0.462,581,1119,0.519,256,694,0.369,560,704,0.795,306,742,1048,473,189,101,371,601,73.2,0.765,7.27,-3.45,62.1,14.0
100313,910,1938,0.47,640,1244,0.514,270,694,0.389,478,627,0.762,331,794,1125,506,175,78,365,492,73.4,0.7140000000000001,2.36,-3.27,65.7,13.0
100314,823,1699,0.484,570,1019,0.5589999999999999,253,680,0.37200000000000005,521,713,0.731,303,705,1008,467,232,114,486,586,71.2,0.765,7.15,-1.13,62.3,14.0
100315,814,1854,0.439,631,1274,0.495,183,580,0.316,560,751,0.746,354,756,1110,398,248,155,411,598,71.8,0.727,15.57,6.73,63.0,5.0
100316,832,1828,0.455,695,1390,0.5,137,438,0.313,554,845,0.6559999999999999,429,806,1235,401,198,193,506,525,67.3,0.6859999999999999,5.11,0.7,62.1,13.0
100317,760,1635,0.465,541,1046,0.517,219,589,0.37200000000000005,499,651,0.767,248,657,905,405,187,100,391,543,69.9,0.7809999999999999,-1.11,-4.21,65.5,13.0
100318,852,1874,0.455,623,1185,0.526,229,689,0.332,436,678,0.643,425,720,1145,485,231,189,458,577,71.8,0.7879999999999999,8.11,0.18,62.8,12.0
100319,837,1775,0.47200000000000003,674,1308,0.515,163,467,0.349,445,666,0.6679999999999999,425,642,1067,537,218,131,364,575,69.2,0.727,18.82,5.63,56.0,8.0
100320,791,1963,0.40299999999999997,561,1234,0.455,230,729,0.316,450,696,0.647,488,731,1219,415,240,208,432,605,66.5,0.647,14.46,6.93,59.0,10.0
100321,761,1748,0.435,548,1173,0.467,213,575,0.37,516,700,0.737,345,677,1022,394,192,71,468,564,64.3,0.6859999999999999,-0.87,-4.53,60.7,15.0
100322,737,1627,0.45299999999999996,548,1091,0.502,189,536,0.353,407,599,0.679,297,662,959,474,240,123,407,556,64.7,0.7809999999999999,15.84,7.59,56.4,2.0
100323,919,2007,0.45799999999999996,730,1404,0.52,189,603,0.313,532,775,0.6859999999999999,435,698,1133,489,307,151,448,619,80.0,0.7190000000000001,0.41,-3.77,71.4,14.0
100324,775,1788,0.433,597,1271,0.47,178,517,0.344,502,732,0.6859999999999999,378,750,1128,328,230,105,439,525,67.6,0.636,11.95,7.95,63.6,10.0
100325,892,1929,0.462,664,1312,0.506,228,617,0.37,438,618,0.7090000000000001,387,759,1146,587,175,132,393,495,70.0,0.7140000000000001,13.74,7.22,63.5,7.0
100326,837,1959,0.42700000000000005,611,1250,0.489,226,709,0.319,509,755,0.674,441,763,1204,400,223,115,537,691,66.9,0.556,-0.65,-1.14,65.7,16.0
100327,872,2002,0.436,634,1344,0.47200000000000003,238,658,0.36200000000000004,432,631,0.685,470,675,1145,557,247,129,403,631,69.0,0.7709999999999999,13.53,6.53,60.4,4.0
100328,824,1839,0.44799999999999995,599,1249,0.48,225,590,0.381,471,684,0.6890000000000001,333,704,1037,510,194,46,390,621,67.0,0.629,1.96,1.05,63.9,15.0
100329,961,2131,0.451,790,1617,0.489,171,514,0.33299999999999996,511,706,0.7240000000000001,387,778,1165,559,283,127,391,526,74.4,0.7140000000000001,12.88,7.82,69.3,6.0
100330,823,1960,0.42,564,1175,0.48,259,785,0.33,369,582,0.634,401,801,1202,465,200,153,334,491,65.0,0.657,18.76,9.73,55.9,5.0
100331,732,1760,0.41600000000000004,528,1143,0.462,204,617,0.331,639,889,0.7190000000000001,383,733,1116,413,263,114,533,651,67.9,0.588,10.74,8.53,65.1,9.0
100332,956,2106,0.45399999999999996,673,1335,0.504,283,771,0.36700000000000005,538,689,0.7809999999999999,395,699,1094,523,222,101,421,582,80.4,0.588,4.04,-0.02,76.3,15.0
100333,803,1847,0.435,644,1354,0.47600000000000003,159,493,0.32299999999999995,495,654,0.757,377,689,1066,394,206,89,376,557,70.6,0.625,11.4,7.09,66.3,10.0
100334,985,1987,0.496,801,1516,0.528,184,471,0.391,554,813,0.6809999999999999,396,790,1186,511,227,147,433,544,77.4,0.6859999999999999,14.32,7.17,70.2,8.0
100335,765,1733,0.441,602,1280,0.47,163,453,0.36,546,728,0.75,343,832,1175,376,184,101,428,580,65.9,0.5589999999999999,-3.31,-5.22,63.9,16.0
100336,950,2060,0.461,790,1535,0.515,160,525,0.305,501,762,0.657,422,817,1239,466,173,149,375,670,71.1,0.611,9.02,7.44,69.6,12.0
100337,754,1850,0.408,536,1196,0.44799999999999995,218,654,0.33299999999999996,415,603,0.688,377,719,1096,394,198,93,303,621,63.0,0.41200000000000003,-1.34,1.69,63.6,16.0
100338,927,2048,0.45299999999999996,722,1417,0.51,205,631,0.325,613,852,0.7190000000000001,501,923,1424,472,192,172,388,617,72.2,0.649,17.34,7.84,61.7,11.0
100339,971,2163,0.449,684,1422,0.48100000000000004,287,741,0.387,644,829,0.777,387,1002,1389,488,281,230,457,719,71.8,0.8,17.23,8.63,63.2,7.0
100340,935,2018,0.46299999999999997,692,1374,0.504,243,644,0.377,558,819,0.6809999999999999,414,875,1289,485,222,96,442,736,72.2,0.703,10.55,5.34,67.0,11.0
100341,945,2056,0.46,690,1345,0.513,255,711,0.359,582,871,0.6679999999999999,437,948,1385,509,274,118,418,611,69.9,0.9229999999999999,20.69,8.54,57.8,1.0
100342,786,1691,0.465,602,1213,0.496,184,478,0.385,587,811,0.7240000000000001,335,757,1092,449,243,155,365,566,73.2,0.8440000000000001,10.79,-0.47,61.0,12.0
100343,1051,2232,0.47100000000000003,763,1449,0.527,288,783,0.368,608,920,0.6609999999999999,503,893,1396,568,370,173,391,723,81.0,0.838,24.69,4.8,61.1,4.0
100344,945,1982,0.47700000000000004,626,1188,0.527,319,794,0.402,527,691,0.763,316,844,1160,525,191,88,336,527,73.9,0.757,18.52,9.65,65.1,2.0
100345,1024,2159,0.474,717,1376,0.521,307,783,0.392,515,728,0.7070000000000001,395,1005,1400,637,259,174,430,721,75.5,0.763,19.35,9.38,65.6,4.0
100346,888,1759,0.505,712,1276,0.5579999999999999,176,483,0.364,540,719,0.7509999999999999,307,774,1081,382,206,145,325,588,75.5,0.7879999999999999,6.31,-0.02,65.6,12.0
100347,928,1977,0.469,669,1311,0.51,259,666,0.389,668,865,0.772,356,803,1159,492,263,113,389,725,81.9,0.706,15.75,8.05,74.1,7.0
100348,895,1944,0.46,712,1422,0.501,183,522,0.35100000000000003,613,861,0.7120000000000001,432,859,1291,563,254,107,373,620,71.8,0.722,17.46,7.54,61.9,9.0
100349,873,2009,0.435,687,1490,0.461,186,519,0.358,598,902,0.6629999999999999,470,894,1364,356,274,183,355,600,70.3,0.861,14.95,4.86,57.0,4.0
100350,829,1869,0.444,639,1268,0.504,190,601,0.316,526,755,0.6970000000000001,345,886,1231,482,253,138,431,597,69.8,0.794,11.63,4.24,61.9,5.0
100351,819,1873,0.43700000000000006,652,1368,0.47700000000000004,167,505,0.331,506,715,0.708,446,754,1200,402,271,171,306,546,68.0,0.8240000000000001,16.05,7.25,59.2,3.0
100352,905,2095,0.43200000000000005,727,1550,0.469,178,545,0.327,610,909,0.6709999999999999,528,921,1449,452,199,206,426,669,74.2,0.6859999999999999,12.67,9.15,70.7,7.0
100353,870,1907,0.456,566,1052,0.5379999999999999,304,855,0.35600000000000004,607,848,0.716,379,884,1263,523,236,141,406,672,78.0,0.853,18.97,7.5,66.5,2.0
100354,927,2019,0.45899999999999996,630,1229,0.513,297,790,0.376,642,861,0.746,337,929,1266,468,183,127,307,574,73.5,0.789,19.69,10.19,64.0,2.0
100355,996,2123,0.469,792,1562,0.507,204,561,0.364,573,870,0.659,465,984,1449,574,223,173,387,630,72.9,0.868,23.36,9.04,58.6,1.0
100356,959,2108,0.455,679,1383,0.491,280,725,0.386,645,949,0.68,525,931,1456,563,197,202,440,648,74.8,0.684,15.8,10.11,67.8,6.0
100357,957,1927,0.49700000000000005,601,1068,0.563,356,859,0.414,486,654,0.743,293,899,1192,614,139,49,342,618,78.7,0.7709999999999999,18.03,7.17,67.9,3.0
100358,972,1963,0.495,717,1320,0.5429999999999999,255,643,0.397,562,793,0.7090000000000001,343,948,1291,525,235,142,419,659,76.7,0.8059999999999999,15.56,5.36,65.9,8.0
100359,1062,2239,0.474,761,1399,0.544,301,840,0.358,564,814,0.693,375,1012,1387,663,214,106,380,623,83.0,0.778,18.52,9.88,74.4,3.0
100360,955,1937,0.493,766,1381,0.555,189,556,0.34,665,935,0.711,416,920,1336,523,204,196,463,732,79.0,0.7140000000000001,20.25,11.4,70.1,2.0
100361,1004,2213,0.45399999999999996,801,1602,0.5,203,611,0.332,781,1146,0.682,562,1045,1607,446,189,236,469,732,74.8,0.725,18.07,9.9,66.6,8.0
100362,958,2009,0.47700000000000004,776,1457,0.5329999999999999,182,552,0.33,516,801,0.644,427,841,1268,591,294,159,449,612,76.9,0.706,13.02,7.14,70.5,8.0
100363,982,2061,0.47600000000000003,692,1305,0.53,290,756,0.384,582,791,0.736,407,931,1338,586,211,147,420,665,78.8,0.75,5.33,-3.42,66.9,14.0
100364,953,2057,0.46299999999999997,807,1623,0.49700000000000005,146,434,0.336,552,882,0.626,483,867,1350,523,249,161,406,690,76.6,0.706,15.24,8.42,69.8,6.0
100365,922,1992,0.46299999999999997,674,1274,0.529,248,718,0.345,569,800,0.711,451,735,1186,574,257,104,393,730,76.0,0.914,4.82,-6.76,63.4,12.0
100366,896,1950,0.45899999999999996,688,1379,0.499,208,571,0.364,616,877,0.7020000000000001,347,910,1257,415,191,154,409,655,72.7,0.639,13.42,9.0,68.3,10.0
100367,1073,2196,0.489,844,1593,0.53,229,603,0.38,628,839,0.7490000000000001,368,940,1308,636,341,111,379,652,81.2,0.757,18.4,7.62,70.4,4.0
100368,855,1884,0.45399999999999996,649,1325,0.49,206,559,0.369,533,792,0.6729999999999999,379,933,1312,484,193,150,362,594,66.2,0.8109999999999999,18.38,7.86,55.7,1.0
100369,896,1942,0.461,646,1229,0.526,250,713,0.35100000000000003,664,916,0.725,419,962,1381,491,247,184,374,611,75.2,0.972,16.65,1.74,59.5,1.0
100370,843,1923,0.43799999999999994,547,1089,0.502,296,834,0.355,522,706,0.7390000000000001,328,725,1053,389,232,99,388,616,75.9,0.485,-6.32,-4.44,77.8,16.0
100371,869,1850,0.47,695,1350,0.515,174,500,0.348,530,770,0.688,379,834,1213,497,196,97,421,674,71.8,0.618,11.84,8.14,68.1,12.0
100372,857,1854,0.462,640,1251,0.512,217,603,0.36,653,910,0.718,386,860,1246,476,155,124,454,561,76.0,0.5589999999999999,-8.41,-10.07,73.9,16.0
100373,919,1984,0.46299999999999997,728,1438,0.506,191,546,0.35,660,898,0.735,447,885,1332,532,234,164,371,603,81.5,0.606,18.58,7.43,70.3,11.0
100374,840,1789,0.47,590,1129,0.523,250,660,0.379,503,780,0.645,319,899,1218,476,151,154,409,544,71.6,0.706,9.05,5.08,67.6,10.0
100375,843,1875,0.45,643,1258,0.511,200,617,0.324,546,793,0.6890000000000001,346,841,1187,421,270,157,394,577,69.5,0.7140000000000001,17.84,8.12,59.8,6.0
100376,805,1893,0.425,609,1308,0.466,196,585,0.335,519,733,0.708,457,767,1224,425,268,188,377,596,68.4,0.794,15.26,5.28,58.4,5.0
100377,828,1837,0.451,620,1273,0.48700000000000004,208,564,0.369,676,1019,0.6629999999999999,415,819,1234,433,273,200,468,799,77.0,0.758,6.04,-0.9,70.0,13.0
100378,808,1804,0.44799999999999995,612,1260,0.486,196,544,0.36,393,592,0.664,352,738,1090,423,205,54,351,578,66.8,0.606,-4.32,-5.95,62.2,15.0
100379,936,2108,0.444,684,1381,0.495,252,727,0.34700000000000003,658,925,0.711,385,879,1264,377,208,123,334,660,79.5,0.7140000000000001,2.73,-1.1,75.7,13.0
100380,909,2034,0.447,624,1282,0.48700000000000004,285,752,0.379,601,802,0.7490000000000001,398,844,1242,483,224,108,376,625,81.9,0.6970000000000001,14.91,8.97,76.0,5.0
100381,1012,2186,0.46299999999999997,835,1687,0.495,177,499,0.355,730,1055,0.6920000000000001,463,969,1432,544,251,103,395,690,83.7,0.657,11.63,5.72,77.3,10.0
100382,814,1871,0.435,633,1302,0.486,181,569,0.318,648,903,0.718,401,904,1305,397,207,115,466,576,70.2,0.657,10.8,8.8,68.2,8.0
100383,936,1918,0.488,742,1395,0.532,194,523,0.371,705,1027,0.6859999999999999,428,918,1346,474,169,224,457,614,77.0,0.722,6.16,-2.58,67.1,13.0
100384,779,1684,0.46299999999999997,584,1091,0.535,195,593,0.32899999999999996,620,856,0.7240000000000001,323,820,1143,376,194,111,464,602,71.9,0.6970000000000001,1.73,-1.45,67.7,14.0
100385,836,1852,0.451,568,1164,0.488,268,688,0.39,546,787,0.6940000000000001,281,891,1172,471,167,182,377,635,75.3,0.636,13.32,7.41,69.4,10.0
100386,808,1888,0.428,563,1134,0.496,245,754,0.325,604,823,0.7340000000000001,343,839,1182,476,200,85,469,630,70.4,0.6,-1.53,-0.44,70.5,15.0
100387,748,1527,0.49,541,981,0.551,207,546,0.379,378,535,0.7070000000000001,232,754,986,492,198,110,464,567,63.1,0.606,0.69,-3.25,59.1,15.0
100388,732,1541,0.475,510,975,0.523,222,566,0.392,568,767,0.741,265,800,1065,407,131,123,382,558,72.7,0.613,-0.92,-4.23,66.5,16.0
100389,719,1684,0.42700000000000005,531,1120,0.474,188,564,0.33299999999999996,511,713,0.7170000000000001,278,781,1059,304,222,99,349,660,66.8,0.594,10.13,8.5,65.2,11.0
100390,988,2127,0.465,742,1457,0.509,246,670,0.36700000000000005,613,913,0.6709999999999999,464,865,1329,472,250,144,459,734,81.0,0.657,2.91,-0.28,75.2,14.0
100391,898,1941,0.46299999999999997,659,1285,0.513,239,656,0.364,693,964,0.7190000000000001,332,871,1203,463,260,160,356,680,80.2,0.618,19.02,8.34,69.6,9.0
100392,847,1832,0.462,663,1287,0.515,184,545,0.33799999999999997,635,872,0.728,403,794,1197,500,262,137,389,660,73.9,0.8240000000000001,3.97,-8.03,59.5,14.0
100393,881,1810,0.48700000000000004,566,1003,0.564,315,807,0.39,600,798,0.752,243,641,884,498,299,67,359,707,78.7,0.706,0.6,-4.34,70.9,15.0
100394,798,1840,0.434,600,1242,0.483,198,598,0.331,486,741,0.6559999999999999,406,774,1180,503,205,98,404,714,69.1,0.606,12.14,8.47,65.4,9.0
100395,839,1812,0.46299999999999997,652,1298,0.502,187,514,0.364,550,845,0.6509999999999999,394,835,1229,461,235,135,428,595,73.2,0.727,10.6,4.42,67.0,9.0
100396,929,2020,0.46,613,1219,0.503,316,801,0.395,571,783,0.7290000000000001,410,797,1207,509,244,105,328,681,78.4,0.743,19.51,8.48,67.4,3.0
100397,849,1984,0.428,631,1356,0.465,218,628,0.34700000000000003,650,831,0.782,432,846,1278,476,194,173,406,603,73.3,0.657,11.37,7.85,69.8,11.0
100398,922,2196,0.42,662,1452,0.456,260,744,0.349,520,772,0.674,479,838,1317,459,391,150,423,686,75.0,0.743,14.55,4.78,65.2,5.0
100399,847,1851,0.45799999999999996,650,1258,0.517,197,593,0.332,625,863,0.7240000000000001,360,936,1296,522,162,172,361,577,74.0,0.794,12.72,4.84,66.1,7.0
100400,900,1962,0.45899999999999996,723,1450,0.499,177,512,0.34600000000000003,525,769,0.6829999999999999,404,863,1267,499,226,178,446,649,75.8,0.727,10.61,6.0,71.2,6.0
100401,835,1899,0.44,638,1296,0.49200000000000005,197,603,0.327,604,894,0.6759999999999999,368,863,1231,427,232,127,394,725,72.7,0.618,6.23,1.17,67.6,13.0
100402,861,1969,0.43700000000000006,649,1341,0.484,212,628,0.33799999999999997,524,758,0.691,434,902,1336,362,216,96,473,668,72.3,0.618,-5.21,-6.31,68.4,16.0
100403,796,1959,0.406,602,1321,0.456,194,638,0.304,560,859,0.652,416,876,1292,372,235,141,494,752,67.0,0.486,-8.25,-7.08,68.2,16.0
100404,848,2003,0.423,628,1341,0.46799999999999997,220,662,0.332,559,723,0.773,430,854,1284,450,225,128,378,668,72.8,0.618,11.39,7.01,68.4,11.0
100405,810,1755,0.462,571,1085,0.526,239,670,0.35700000000000004,580,846,0.6859999999999999,255,866,1121,490,250,91,415,573,67.8,0.75,10.98,4.06,60.8,11.0
100406,854,1926,0.44299999999999995,633,1336,0.474,221,590,0.375,485,684,0.7090000000000001,367,795,1162,428,300,100,467,650,69.0,0.5710000000000001,-3.02,-3.5,68.5,16.0
100407,1009,2068,0.488,816,1532,0.5329999999999999,193,536,0.36,700,974,0.7190000000000001,411,988,1399,528,275,131,419,681,76.6,0.895,24.33,7.41,59.7,2.0
100408,978,2196,0.445,740,1515,0.488,238,681,0.349,593,819,0.7240000000000001,470,820,1290,579,277,168,430,684,77.4,0.75,14.07,6.79,70.1,5.0
100409,814,1882,0.433,622,1342,0.46299999999999997,192,540,0.35600000000000004,526,767,0.6859999999999999,408,831,1239,387,217,103,376,592,69.0,0.6759999999999999,16.64,8.62,61.0,6.0
100410,761,1705,0.446,594,1198,0.496,167,507,0.32899999999999996,424,633,0.67,383,795,1178,394,222,185,432,507,62.1,0.6759999999999999,10.72,4.4,55.8,8.0
100411,799,1753,0.456,598,1184,0.505,201,569,0.353,541,769,0.7040000000000001,367,785,1152,427,251,156,415,668,70.9,0.667,15.48,9.81,65.2,4.0
100412,902,1878,0.48,728,1356,0.537,174,522,0.33299999999999996,521,719,0.725,322,794,1116,479,321,143,366,642,71.4,0.7140000000000001,5.47,-2.03,62.4,14.0
100413,1006,2150,0.46799999999999997,803,1568,0.512,203,582,0.349,685,943,0.726,491,991,1482,553,253,268,408,665,74.4,0.9740000000000001,28.72,8.67,54.3,1.0
100414,895,2054,0.436,659,1393,0.473,236,661,0.35700000000000004,499,727,0.6859999999999999,435,934,1369,415,138,184,375,637,70.1,0.611,14.11,9.72,65.8,8.0
100415,1099,2309,0.47600000000000003,915,1795,0.51,184,514,0.358,571,814,0.701,526,1015,1541,661,251,160,481,738,77.7,0.684,20.63,11.76,68.8,4.0
100416,1050,2061,0.509,748,1286,0.5820000000000001,302,775,0.39,561,756,0.742,313,918,1231,576,256,138,357,540,78.0,0.8420000000000001,19.23,7.02,65.8,3.0
100417,964,1995,0.483,728,1358,0.536,236,637,0.37,471,693,0.68,387,854,1241,534,266,178,396,563,75.3,0.6859999999999999,19.68,7.37,63.0,10.0
100418,873,2042,0.428,671,1435,0.46799999999999997,202,607,0.33299999999999996,528,715,0.738,434,888,1322,516,237,184,482,630,68.8,0.556,1.94,1.62,68.1,14.0
100419,930,2099,0.44299999999999995,707,1493,0.474,223,606,0.368,507,750,0.6759999999999999,440,927,1367,498,238,139,430,645,71.9,0.611,12.07,8.27,68.1,11.0
100420,849,1760,0.48200000000000004,585,1106,0.529,264,654,0.40399999999999997,534,760,0.703,322,882,1204,489,208,175,407,581,71.3,0.743,20.98,7.42,57.1,5.0
100421,916,1951,0.47,590,1114,0.53,326,837,0.389,596,815,0.731,371,864,1235,570,278,146,382,596,76.5,0.917,23.13,7.55,60.9,1.0
100422,956,2011,0.475,722,1345,0.537,234,666,0.35100000000000003,566,775,0.73,364,918,1282,596,223,106,447,661,73.3,0.622,15.42,9.48,67.4,6.0
100423,1099,2191,0.502,816,1459,0.5589999999999999,283,732,0.387,610,873,0.6990000000000001,445,991,1436,588,278,149,421,607,79.3,0.897,24.97,9.87,64.2,1.0
100424,1084,2083,0.52,820,1423,0.5760000000000001,264,660,0.4,557,806,0.691,391,1050,1441,620,226,126,397,637,78.7,0.9209999999999999,21.12,5.12,61.7,2.0
100425,821,1905,0.431,629,1329,0.473,192,576,0.33299999999999996,538,723,0.7440000000000001,422,852,1274,482,218,158,377,536,69.8,0.647,15.83,8.39,62.3,7.0
100426,869,1976,0.44,656,1414,0.46399999999999997,213,562,0.379,610,842,0.7240000000000001,426,938,1364,475,237,175,463,639,71.1,0.75,18.47,12.13,64.8,2.0
100427,878,2048,0.429,680,1404,0.484,198,644,0.307,529,792,0.6679999999999999,454,897,1351,419,283,192,408,623,69.0,0.75,18.12,8.98,59.8,4.0
100428,781,1777,0.44,523,1090,0.48,258,687,0.376,597,790,0.7559999999999999,314,909,1223,376,169,151,431,584,69.1,0.8,13.32,7.63,63.4,4.0
100429,1014,2181,0.465,720,1418,0.508,294,763,0.385,451,714,0.632,436,1022,1458,646,203,176,441,738,71.1,0.6920000000000001,17.46,10.0,63.6,7.0
100430,776,1618,0.48,519,973,0.5329999999999999,257,645,0.39799999999999996,472,644,0.733,255,816,1071,413,207,84,363,508,65.2,0.8859999999999999,12.54,2.0,54.6,5.0
100431,885,2035,0.435,649,1347,0.48200000000000004,236,688,0.34299999999999997,495,668,0.741,389,943,1332,430,237,174,419,570,71.5,0.6859999999999999,18.65,9.94,62.7,3.0
100432,992,2143,0.46299999999999997,729,1417,0.514,263,726,0.36200000000000004,466,613,0.76,372,926,1298,508,207,157,421,655,75.4,0.722,11.43,7.65,70.8,8.0
100433,800,1916,0.418,611,1325,0.461,189,591,0.32,437,694,0.63,439,831,1270,377,247,179,410,506,61.8,0.75,11.81,4.24,53.9,8.0
100434,804,1758,0.457,634,1275,0.49700000000000005,170,483,0.35200000000000004,446,614,0.726,358,874,1232,430,186,143,316,484,65.4,0.882,21.73,7.81,51.5,2.0
100435,872,2138,0.408,645,1419,0.455,227,719,0.316,571,863,0.662,575,697,1272,494,376,96,453,821,72.6,0.7140000000000001,15.12,9.29,66.8,5.0
100436,860,1933,0.445,621,1263,0.49200000000000005,239,670,0.35700000000000004,501,715,0.701,415,830,1245,476,250,134,327,587,70.3,0.857,15.56,3.68,57.4,7.0
100437,1014,2115,0.479,726,1325,0.5479999999999999,288,790,0.365,584,765,0.763,383,955,1338,504,174,127,296,501,72.5,0.9,24.61,10.29,58.2,1.0
100438,756,1748,0.43200000000000005,541,1108,0.488,215,640,0.336,573,829,0.691,345,720,1065,460,264,92,481,758,69.7,0.5760000000000001,-1.34,-3.34,67.7,16.0
100439,976,2090,0.467,676,1327,0.509,300,763,0.39299999999999996,679,886,0.7659999999999999,421,928,1349,594,257,103,417,721,83.7,0.7140000000000001,13.53,5.02,73.2,11.0
100440,831,1823,0.456,534,1065,0.501,297,758,0.392,431,591,0.7290000000000001,298,821,1119,409,206,79,348,582,70.3,0.735,10.01,1.38,60.1,11.0
100441,897,1910,0.47,580,1100,0.527,317,810,0.391,540,747,0.723,339,880,1219,506,214,146,436,568,75.7,0.657,-0.82,-5.94,68.1,16.0
100442,818,1840,0.445,633,1266,0.5,185,574,0.322,569,861,0.6609999999999999,394,799,1193,375,214,109,454,609,68.3,0.629,-5.98,-6.09,68.2,15.0
100443,818,1802,0.45399999999999996,596,1206,0.494,222,596,0.37200000000000005,473,688,0.688,324,815,1139,461,228,87,379,589,66.6,0.8,2.56,-2.98,59.7,12.0
100444,796,1837,0.433,584,1211,0.48200000000000004,212,626,0.33899999999999997,486,671,0.7240000000000001,422,929,1351,442,128,265,435,555,67.4,0.588,16.16,9.07,60.3,11.0
100445,827,1840,0.449,632,1243,0.508,195,597,0.327,524,767,0.6829999999999999,409,840,1249,505,185,177,444,642,69.9,0.618,12.93,7.64,64.6,9.0
100446,977,2045,0.478,633,1185,0.534,344,860,0.4,522,719,0.726,351,832,1183,454,219,167,376,624,80.6,0.743,0.79,-3.84,73.9,13.0
100447,813,1874,0.434,577,1248,0.462,236,626,0.377,487,723,0.674,497,836,1333,497,263,132,434,565,69.1,0.706,17.85,9.33,60.2,3.0
100448,892,1962,0.455,703,1404,0.501,189,558,0.33899999999999997,450,658,0.684,401,893,1294,516,240,204,476,516,73.4,0.667,11.39,5.63,67.7,9.0
100449,671,1548,0.433,525,1136,0.462,146,412,0.354,438,609,0.7190000000000001,316,709,1025,384,213,135,349,472,64.2,0.733,4.47,-0.25,57.6,13.0
100450,838,1725,0.486,635,1199,0.53,203,526,0.386,518,713,0.727,297,863,1160,500,183,129,483,496,68.5,0.657,2.03,-1.34,65.1,14.0
100451,896,2139,0.419,603,1285,0.469,293,854,0.34299999999999997,524,797,0.657,444,833,1277,456,342,153,383,690,72.5,0.722,12.79,6.1,65.8,7.0
100452,940,1973,0.47600000000000003,677,1247,0.5429999999999999,263,726,0.36200000000000004,502,721,0.696,323,898,1221,546,218,133,375,527,77.8,0.735,17.94,9.15,69.0,3.0
100453,832,1750,0.475,687,1350,0.509,145,400,0.363,541,770,0.703,388,856,1244,524,237,146,426,551,69.1,0.794,12.94,3.57,59.8,6.0
100454,911,1870,0.48700000000000004,649,1178,0.551,262,692,0.379,588,799,0.736,413,763,1176,596,259,120,476,734,78.6,0.853,8.61,-4.2,64.4,12.0
100455,872,1799,0.485,611,1159,0.527,261,640,0.408,421,549,0.767,282,735,1017,514,181,83,366,515,73.5,0.606,-3.37,-3.12,73.0,16.0
100456,828,1889,0.43799999999999994,657,1343,0.489,171,546,0.313,543,768,0.7070000000000001,411,817,1228,474,242,155,407,628,69.7,0.647,13.71,9.5,65.5,6.0
100457,743,1713,0.434,513,1113,0.461,230,600,0.38299999999999995,425,614,0.6920000000000001,274,824,1098,315,156,123,325,504,64.9,0.6970000000000001,-1.72,-3.63,62.3,15.0
100458,898,1924,0.467,555,1047,0.53,343,877,0.391,390,553,0.705,335,809,1144,547,171,93,303,601,79.0,0.75,11.97,3.19,69.4,10.0
100459,808,1748,0.462,643,1298,0.495,165,450,0.36700000000000005,535,771,0.6940000000000001,428,771,1199,406,219,124,470,541,68.1,0.6759999999999999,3.71,-3.67,59.8,15.0
100460,854,1851,0.461,637,1293,0.493,217,558,0.389,370,541,0.684,329,869,1198,480,194,168,396,578,67.5,0.618,3.63,0.45,62.1,13.0
100461,837,1836,0.456,601,1216,0.494,236,620,0.381,456,676,0.675,397,879,1276,443,203,157,422,563,69.6,0.8240000000000001,6.29,-2.0,59.4,13.0
100462,747,1730,0.43200000000000005,563,1192,0.47200000000000003,184,538,0.342,572,826,0.6920000000000001,360,900,1260,411,183,151,420,608,68.2,0.636,12.42,8.6,64.4,10.0
100463,747,1619,0.461,538,977,0.551,209,642,0.326,448,638,0.7020000000000001,216,831,1047,501,191,102,392,481,61.5,0.7140000000000001,3.81,-0.04,56.4,12.0
100464,729,1666,0.43799999999999994,524,1094,0.479,205,572,0.358,493,650,0.758,334,777,1111,349,187,53,381,544,65.3,0.727,-0.34,-5.18,60.5,14.0
100465,733,1667,0.44,507,1020,0.49700000000000005,226,647,0.349,468,645,0.726,287,752,1039,366,253,156,392,614,67.5,0.563,12.95,9.63,62.8,9.0
100466,835,1890,0.442,637,1321,0.48200000000000004,198,569,0.348,475,687,0.691,336,828,1164,408,246,210,352,587,71.0,0.636,11.85,9.04,67.9,9.0
100467,858,1803,0.47600000000000003,529,937,0.565,329,866,0.38,405,585,0.6920000000000001,307,786,1093,504,209,66,451,549,74.2,0.667,0.35,-2.77,70.6,15.0
100468,837,1922,0.435,638,1339,0.47600000000000003,199,583,0.341,589,819,0.7190000000000001,420,840,1260,433,248,132,378,613,74.6,0.6970000000000001,7.93,1.6,68.3,12.0
100469,923,1989,0.46399999999999997,604,1203,0.502,319,786,0.406,468,651,0.7190000000000001,407,817,1224,473,170,108,392,606,77.4,0.588,12.94,7.2,71.7,10.0
100470,836,1899,0.44,608,1266,0.48,228,633,0.36,538,780,0.69,447,891,1338,385,240,111,399,559,71.7,0.706,-1.02,-6.18,62.4,16.0
100471,1008,2106,0.479,822,1579,0.521,186,527,0.353,501,778,0.644,417,1005,1422,483,230,141,438,674,77.2,0.6,-0.79,-3.82,70.7,16.0
100472,867,2023,0.429,617,1252,0.493,250,771,0.324,551,768,0.7170000000000001,408,897,1305,489,255,125,346,705,72.4,0.743,17.39,4.24,59.0,11.0
100473,775,1879,0.41200000000000003,524,1110,0.47200000000000003,251,769,0.326,466,678,0.687,279,773,1052,480,219,86,386,585,64.8,0.429,-11.2,-6.11,69.9,16.0
100474,947,2048,0.462,605,1147,0.527,342,901,0.38,420,569,0.738,290,862,1152,537,203,81,348,558,73.8,0.639,13.75,7.92,67.4,11.0
100475,886,1958,0.45299999999999996,620,1265,0.49,266,693,0.384,449,616,0.7290000000000001,324,871,1195,451,230,106,355,640,71.1,0.857,7.12,-1.76,60.8,12.0
100476,918,1969,0.466,682,1368,0.499,236,601,0.39299999999999996,566,774,0.731,366,822,1188,468,227,107,335,646,79.9,0.667,16.46,7.55,71.0,9.0
100477,944,2078,0.45399999999999996,689,1379,0.5,255,699,0.365,488,615,0.7929999999999999,338,962,1300,489,210,182,385,657,73.1,0.6940000000000001,15.89,6.28,63.5,9.0
100478,983,2136,0.46,655,1285,0.51,328,851,0.385,626,866,0.723,426,870,1296,478,226,154,354,603,81.1,0.6940000000000001,19.23,10.59,72.5,4.0
100479,1011,2081,0.486,730,1343,0.544,281,738,0.381,537,708,0.758,382,1044,1426,501,184,111,418,623,78.9,0.778,16.92,4.23,65.6,11.0
100480,1021,2034,0.502,676,1203,0.562,345,831,0.415,504,688,0.733,414,874,1288,560,239,137,474,647,82.6,0.7709999999999999,19.59,6.9,69.9,5.0
100481,1087,2159,0.503,794,1401,0.5670000000000001,293,758,0.387,395,563,0.7020000000000001,304,940,1244,577,218,142,398,542,81.8,0.657,16.93,10.16,75.0,4.0
100482,1092,2207,0.495,788,1479,0.5329999999999999,304,728,0.418,601,843,0.713,402,1041,1443,604,253,158,478,719,81.3,0.868,23.87,11.22,67.6,1.0
100483,1028,2149,0.478,784,1483,0.529,244,666,0.366,561,813,0.69,462,933,1395,512,206,207,389,735,79.5,0.75,20.23,8.84,68.1,4.0
100484,907,1895,0.479,666,1252,0.532,241,643,0.375,578,772,0.7490000000000001,330,877,1207,438,215,127,383,581,75.2,0.7709999999999999,18.52,10.69,67.4,3.0
100485,1235,2560,0.48200000000000004,1011,1875,0.539,224,685,0.327,617,826,0.747,568,1056,1624,708,269,177,431,718,82.8,0.825,23.44,10.69,70.0,1.0
100486,881,2093,0.42100000000000004,632,1317,0.48,249,776,0.321,566,781,0.725,402,861,1263,550,229,123,397,591,73.6,0.6859999999999999,11.94,8.46,70.1,9.0
100487,977,2000,0.489,704,1254,0.561,273,746,0.366,551,764,0.721,347,988,1335,557,199,149,451,549,77.2,0.75,15.5,8.79,69.5,3.0
100488,964,1964,0.491,740,1407,0.526,224,557,0.402,474,630,0.752,323,866,1189,551,199,119,345,596,71.0,0.784,22.04,11.12,60.1,1.0
100489,795,1693,0.47,605,1170,0.517,190,523,0.363,468,699,0.67,407,801,1208,452,170,137,398,530,74.9,0.767,9.08,-1.03,63.8,12.0
100490,893,1946,0.45899999999999996,656,1209,0.5429999999999999,237,737,0.322,597,873,0.684,362,908,1270,525,257,124,443,695,77.1,0.8240000000000001,9.03,-1.04,66.7,13.0
100491,906,2027,0.447,637,1308,0.48700000000000004,269,719,0.374,480,669,0.7170000000000001,392,865,1257,523,223,156,339,538,77.6,0.667,17.01,8.71,69.3,7.0
100492,943,1941,0.486,676,1202,0.562,267,739,0.361,572,745,0.768,319,969,1288,488,210,194,458,605,75.7,0.75,16.71,8.31,66.7,5.0
100493,909,2025,0.449,630,1309,0.48100000000000004,279,716,0.39,442,718,0.616,369,914,1283,455,215,123,419,700,72.5,0.7140000000000001,2.66,-0.7,68.9,15.0
100494,849,1864,0.455,551,1068,0.516,298,796,0.374,479,633,0.757,195,896,1091,429,204,94,357,560,68.8,0.639,8.78,4.44,64.0,11.0
100495,972,2042,0.47600000000000003,710,1342,0.529,262,700,0.374,498,671,0.742,381,884,1265,480,197,143,359,544,75.1,0.667,14.1,9.57,70.6,6.0
100496,1018,2225,0.45799999999999996,636,1319,0.48200000000000004,382,906,0.42200000000000004,530,734,0.722,407,1011,1418,537,247,188,484,630,79.7,0.784,19.76,11.14,71.1,2.0
100497,1041,2230,0.467,781,1472,0.531,260,758,0.34299999999999997,648,906,0.715,442,940,1382,517,275,221,431,675,78.7,0.816,18.05,8.64,68.8,1.0
100498,972,2032,0.478,703,1291,0.545,269,741,0.363,515,701,0.735,405,783,1188,635,310,122,411,700,80.2,0.8240000000000001,9.23,-5.47,63.3,14.0
100499,976,2153,0.45299999999999996,725,1386,0.523,251,767,0.327,577,806,0.716,364,1014,1378,534,184,119,355,583,77.2,0.778,12.1,4.93,70.1,8.0
100500,884,2080,0.425,569,1204,0.473,315,876,0.36,506,736,0.688,445,874,1319,493,300,162,440,598,70.0,0.622,14.62,9.75,65.1,10.0
100501,991,2208,0.449,710,1384,0.513,281,824,0.341,565,841,0.672,477,984,1461,612,260,133,434,668,76.4,0.757,18.45,8.45,66.4,3.0
100502,1010,2238,0.451,748,1493,0.501,262,745,0.35200000000000004,499,721,0.6920000000000001,447,900,1347,515,309,135,405,706,77.3,0.6940000000000001,13.83,4.35,67.8,10.0
100503,1086,2247,0.483,739,1288,0.574,347,959,0.36200000000000004,599,766,0.782,351,1034,1385,637,282,136,440,681,78.0,0.875,24.08,9.71,63.6,2.0
100504,816,1917,0.426,587,1261,0.466,229,656,0.349,512,728,0.703,398,830,1228,400,205,114,386,588,67.8,0.629,13.4,9.4,63.8,7.0
100505,928,2054,0.452,673,1352,0.498,255,702,0.363,626,857,0.73,436,951,1387,548,246,101,429,678,80.5,0.8240000000000001,18.58,8.43,70.4,2.0
100506,929,2029,0.45799999999999996,691,1372,0.504,238,657,0.36200000000000004,462,663,0.6970000000000001,348,760,1108,472,250,87,423,720,77.5,0.545,-10.9,-8.31,78.8,16.0
100507,857,1879,0.456,584,1165,0.501,273,714,0.382,519,747,0.695,313,960,1273,487,139,182,386,632,75.9,0.5760000000000001,17.2,8.68,67.4,11.0
100508,909,2046,0.444,698,1436,0.486,211,610,0.34600000000000003,505,754,0.67,365,893,1258,381,258,123,391,680,72.4,0.629,-7.68,-9.37,68.7,16.0
100509,821,1849,0.444,602,1178,0.511,219,671,0.326,495,731,0.677,323,800,1123,435,216,88,346,563,73.6,0.625,9.79,5.76,69.6,11.0
100510,960,2042,0.47,692,1311,0.528,268,731,0.36700000000000005,538,723,0.7440000000000001,407,1036,1443,615,147,165,419,607,77.9,0.743,20.17,7.46,65.2,5.0
100511,785,1754,0.44799999999999995,600,1220,0.49200000000000005,185,534,0.34600000000000003,550,741,0.742,326,760,1086,418,190,134,385,589,72.0,0.594,12.41,10.25,69.9,8.0
100512,865,2029,0.426,613,1382,0.444,252,647,0.389,594,808,0.735,446,988,1434,461,177,167,454,638,75.8,0.647,12.04,7.64,70.8,8.0
100513,928,2039,0.455,698,1362,0.512,230,677,0.34,534,760,0.703,397,840,1237,438,246,143,374,793,79.4,0.758,6.25,0.35,72.1,13.0
100514,892,1999,0.446,686,1405,0.488,206,594,0.34700000000000003,532,808,0.6579999999999999,438,917,1355,455,251,155,469,636,74.2,0.735,14.66,8.28,67.8,6.0
100515,897,1963,0.457,635,1234,0.515,262,729,0.359,596,811,0.735,381,860,1241,504,272,165,437,596,75.8,0.8290000000000001,3.24,-3.46,67.5,12.0
100516,919,2011,0.457,592,1127,0.525,327,884,0.37,463,651,0.711,348,870,1218,551,248,135,422,642,79.6,0.667,3.59,-1.78,74.3,13.0
100517,945,2049,0.461,722,1404,0.514,223,645,0.34600000000000003,627,936,0.67,422,904,1326,479,250,101,502,633,76.1,0.5,-6.04,-2.98,76.8,16.0
100518,933,1992,0.46799999999999997,713,1394,0.511,220,598,0.368,429,637,0.6729999999999999,426,886,1312,541,204,150,379,523,76.2,0.7879999999999999,3.75,-5.28,64.1,13.0
100519,915,2096,0.43700000000000006,652,1320,0.494,263,776,0.33899999999999997,616,867,0.71,425,938,1363,441,240,124,475,748,77.4,0.5710000000000001,1.34,0.9,75.3,14.0
100520,982,2138,0.45899999999999996,716,1450,0.494,266,688,0.387,507,750,0.6759999999999999,401,936,1337,504,215,181,415,590,80.5,0.618,13.52,7.64,74.6,8.0
100521,926,2126,0.436,707,1488,0.475,219,638,0.34299999999999997,559,805,0.6940000000000001,409,884,1293,466,295,138,378,764,75.1,0.7140000000000001,5.27,2.24,70.7,14.0
100522,810,1967,0.41200000000000003,604,1289,0.469,206,678,0.304,537,815,0.659,447,875,1322,381,169,117,440,649,73.8,0.6559999999999999,-8.74,-8.45,74.1,16.0
100523,946,1970,0.48,725,1390,0.522,221,580,0.381,622,863,0.721,394,974,1368,485,164,161,442,621,80.4,0.735,18.79,7.23,68.9,6.0
100524,933,2003,0.466,723,1431,0.505,210,572,0.36700000000000005,545,752,0.725,467,800,1267,603,269,135,432,660,77.1,0.647,16.13,9.76,69.6,5.0
100525,890,1931,0.461,654,1280,0.511,236,651,0.363,529,806,0.6559999999999999,386,963,1349,430,139,159,419,706,74.9,0.6759999999999999,15.39,7.87,67.3,4.0
100526,822,2021,0.40700000000000003,567,1264,0.449,255,757,0.337,368,538,0.684,371,854,1225,445,173,103,305,535,68.7,0.636,7.69,6.57,67.6,10.0
100527,877,1950,0.45,622,1235,0.504,255,715,0.35700000000000004,582,783,0.743,381,898,1279,381,169,84,399,670,76.2,0.765,5.44,-1.22,68.1,12.0
100528,1009,2078,0.486,688,1339,0.514,321,739,0.434,454,623,0.7290000000000001,427,1027,1454,719,156,177,406,671,79.8,0.8290000000000001,22.59,6.94,64.1,2.0
100529,814,1884,0.43200000000000005,582,1203,0.484,232,681,0.341,495,743,0.6659999999999999,363,776,1139,377,167,144,341,688,71.4,0.606,14.8,11.71,68.3,6.0
100530,875,1939,0.451,696,1415,0.49200000000000005,179,524,0.342,476,726,0.6559999999999999,414,849,1263,516,263,165,405,707,72.9,0.727,2.58,-5.15,63.8,15.0
100531,943,2102,0.449,734,1459,0.503,209,643,0.325,654,972,0.6729999999999999,558,822,1380,510,343,93,498,819,78.5,0.743,21.61,9.78,66.7,3.0
100532,851,1980,0.43,599,1255,0.47700000000000004,252,725,0.348,464,658,0.705,441,850,1291,508,257,192,363,513,73.3,0.667,15.19,5.25,63.3,9.0
100533,836,1836,0.455,615,1193,0.516,221,643,0.344,500,749,0.6679999999999999,327,938,1265,480,196,145,427,626,72.5,0.758,11.34,4.76,65.9,7.0
100534,1048,2350,0.446,793,1620,0.49,255,730,0.349,662,1007,0.657,458,927,1385,501,358,166,441,724,83.7,0.639,1.16,-0.67,80.0,14.0
100535,811,1843,0.44,593,1256,0.47200000000000003,218,587,0.371,461,687,0.6709999999999999,337,765,1102,432,236,106,361,642,71.9,0.594,10.39,9.26,70.1,7.0
100536,898,1973,0.455,703,1370,0.513,195,603,0.32299999999999995,561,808,0.6940000000000001,396,882,1278,422,312,112,444,587,75.1,0.647,1.1,-3.25,68.0,15.0
100537,878,1919,0.45799999999999996,674,1330,0.507,204,589,0.34600000000000003,516,686,0.752,417,840,1257,547,162,121,384,581,75.0,0.636,15.47,8.75,67.3,10.0
100538,908,1885,0.48200000000000004,617,1100,0.561,291,785,0.371,555,821,0.6759999999999999,300,996,1296,477,175,119,462,611,76.1,0.743,0.18,-5.13,67.0,15.0
100539,869,1883,0.461,622,1200,0.518,247,683,0.36200000000000004,538,775,0.6940000000000001,330,802,1132,521,271,130,453,630,72.1,0.6,14.8,10.48,67.8,11.0
100540,877,1977,0.444,616,1247,0.494,261,730,0.358,431,640,0.6729999999999999,276,806,1082,403,222,142,472,640,67.9,0.556,-4.29,-3.51,68.7,16.0
100541,873,2008,0.435,652,1373,0.475,221,635,0.348,558,828,0.674,364,916,1280,461,202,118,513,688,70.1,0.639,-5.21,-4.68,69.6,16.0
100542,975,2139,0.456,692,1357,0.51,283,782,0.36200000000000004,583,787,0.741,387,899,1286,550,252,190,398,571,78.2,0.722,11.48,6.4,73.1,11.0
100543,977,2048,0.47700000000000004,733,1423,0.515,244,625,0.39,635,830,0.765,380,978,1358,501,201,119,413,625,76.6,0.865,18.25,7.63,65.9,2.0
100544,906,1898,0.47700000000000004,645,1184,0.545,261,714,0.366,522,704,0.741,287,804,1091,453,206,96,346,640,76.3,0.735,17.7,10.23,68.9,4.0
100545,953,2118,0.45,675,1342,0.503,278,776,0.358,620,851,0.7290000000000001,416,915,1331,450,272,167,431,661,77.9,0.75,22.4,11.01,66.5,4.0
100546,1036,2146,0.483,803,1475,0.544,233,671,0.34700000000000003,568,824,0.6890000000000001,409,915,1324,511,259,180,415,684,82.1,0.743,18.87,8.87,72.1,3.0
100547,1149,2280,0.504,863,1531,0.564,286,749,0.382,638,890,0.7170000000000001,378,1209,1587,595,265,183,448,660,82.6,0.9490000000000001,25.26,4.13,61.5,1.0
100548,1031,2186,0.47200000000000003,687,1326,0.518,344,860,0.4,423,604,0.7,318,901,1219,553,272,124,355,557,80.8,0.6859999999999999,20.51,11.94,72.3,5.0
100549,1014,2077,0.488,786,1455,0.54,228,622,0.36700000000000005,441,631,0.6990000000000001,355,918,1273,552,242,100,374,655,74.9,0.861,9.8,-0.48,63.9,12.0
100550,913,2094,0.436,657,1347,0.488,256,747,0.34299999999999997,476,637,0.747,386,918,1304,540,190,175,383,691,71.1,0.667,14.02,8.43,65.5,8.0
100551,980,2139,0.45799999999999996,646,1270,0.509,334,869,0.384,489,611,0.8,334,878,1212,566,255,134,341,533,77.3,0.722,17.81,9.78,69.3,5.0
100552,980,2044,0.479,665,1262,0.527,315,782,0.40299999999999997,515,680,0.757,344,978,1322,640,181,87,455,552,79.7,0.7709999999999999,20.13,8.79,68.4,4.0
100553,892,1797,0.496,599,1053,0.569,293,744,0.39399999999999996,372,499,0.745,324,881,1205,563,143,110,365,512,72.0,0.853,16.75,2.19,57.5,7.0
100554,965,1948,0.495,654,1105,0.5920000000000001,311,843,0.369,538,681,0.79,316,892,1208,505,259,109,402,515,77.2,0.889,23.8,9.28,62.7,1.0
100555,839,1823,0.46,607,1221,0.49700000000000005,232,602,0.385,336,474,0.7090000000000001,297,822,1119,473,190,138,324,556,66.1,0.6759999999999999,20.63,10.93,56.4,5.0
100556,1059,2333,0.45399999999999996,784,1574,0.498,275,759,0.36200000000000004,621,907,0.685,534,853,1387,607,371,176,455,756,81.5,0.757,24.45,9.67,66.7,4.0
100557,971,2135,0.455,688,1347,0.511,283,788,0.359,453,703,0.644,460,917,1377,504,250,130,411,602,72.4,0.73,19.4,9.4,62.4,8.0
100558,981,2148,0.457,714,1373,0.52,267,775,0.345,607,882,0.688,451,965,1416,560,228,100,478,711,74.6,0.632,14.8,11.51,71.3,11.0
100559,997,2165,0.461,764,1527,0.5,233,638,0.365,628,825,0.7609999999999999,401,897,1298,497,278,170,428,739,79.3,0.722,14.04,8.6,73.9,8.0
100560,921,1956,0.47100000000000003,691,1315,0.525,230,641,0.359,478,661,0.723,451,878,1329,544,180,166,469,617,72.9,0.7709999999999999,19.75,11.87,63.7,3.0
100561,969,2116,0.45799999999999996,705,1352,0.521,264,764,0.34600000000000003,472,688,0.6859999999999999,437,891,1328,557,261,173,361,566,74.3,0.833,18.43,5.49,61.3,6.0
100562,1019,2144,0.475,708,1322,0.536,311,822,0.37799999999999995,642,842,0.762,390,951,1341,484,226,172,421,675,80.8,0.757,21.56,10.91,70.2,2.0
100563,1071,2193,0.488,753,1406,0.536,318,787,0.40399999999999997,535,789,0.6779999999999999,428,965,1393,584,250,162,456,639,83.2,0.861,23.53,12.23,71.9,1.0
100564,1134,2396,0.473,867,1639,0.529,267,757,0.353,690,980,0.7040000000000001,470,1042,1512,585,229,200,443,716,84.9,0.8420000000000001,23.88,10.49,71.5,2.0
100565,952,2085,0.457,714,1415,0.505,238,670,0.355,486,708,0.6859999999999999,457,886,1343,461,227,186,374,652,77.3,0.735,22.47,11.15,66.0,2.0
100566,1002,2076,0.483,641,1139,0.563,361,937,0.385,486,624,0.779,280,831,1111,527,220,108,348,571,75.0,0.684,18.8,10.17,66.4,7.0
100567,905,1927,0.47,632,1195,0.529,273,732,0.373,432,646,0.669,328,947,1275,591,151,162,490,699,71.9,0.5710000000000001,13.67,10.5,68.7,9.0
100568,1226,2633,0.466,943,1835,0.514,283,798,0.355,642,916,0.701,630,1118,1748,722,283,139,473,711,84.4,0.825,24.84,11.76,70.6,1.0
100569,1091,2270,0.48100000000000004,757,1390,0.545,334,880,0.38,560,787,0.7120000000000001,412,1019,1431,614,253,248,454,614,78.9,0.846,20.8,8.38,65.8,3.0
100570,916,2019,0.45399999999999996,699,1366,0.512,217,653,0.332,528,791,0.6679999999999999,409,892,1301,467,227,206,389,725,73.6,0.7140000000000001,12.88,4.62,65.4,11.0
100571,924,2197,0.42100000000000004,676,1464,0.462,248,733,0.33799999999999997,611,874,0.6990000000000001,464,882,1346,468,288,142,480,751,73.2,0.703,17.52,10.16,65.2,7.0
100572,1210,2320,0.522,856,1448,0.591,354,872,0.406,459,622,0.738,343,1043,1386,771,212,191,404,583,89.8,0.861,20.67,6.39,75.5,3.0
100573,992,2114,0.469,682,1345,0.507,310,769,0.40299999999999997,622,848,0.733,434,1038,1472,586,235,140,406,676,81.0,0.861,21.24,2.96,62.4,10.0
100574,923,1955,0.47200000000000003,655,1258,0.521,268,697,0.385,619,795,0.779,349,850,1199,512,183,121,389,668,82.8,0.5760000000000001,14.19,9.8,78.4,11.0
100575,830,1755,0.473,691,1317,0.525,139,438,0.317,532,749,0.71,386,754,1140,500,252,97,534,562,72.8,0.625,-4.1,-5.34,69.2,16.0
100576,910,2005,0.45399999999999996,655,1244,0.527,255,761,0.335,467,684,0.6829999999999999,397,916,1313,480,209,112,406,587,74.8,0.735,-3.18,-12.12,63.5,16.0
100577,804,1795,0.44799999999999995,565,1150,0.491,239,645,0.371,472,683,0.691,294,807,1101,471,218,98,412,569,70.3,0.606,11.24,7.84,66.9,11.0
100578,926,1919,0.483,698,1334,0.523,228,585,0.39,498,698,0.713,297,849,1146,487,251,93,419,672,80.6,0.688,-1.83,-5.45,73.7,15.0
100579,891,1957,0.455,578,1118,0.517,313,839,0.373,520,725,0.7170000000000001,316,908,1224,423,216,169,430,605,79.2,0.7879999999999999,1.34,-6.12,70.4,13.0
100580,960,1967,0.488,695,1274,0.546,265,693,0.382,597,850,0.7020000000000001,357,912,1269,516,293,162,519,698,79.5,0.7709999999999999,7.31,-2.11,69.7,13.0
100581,1007,2017,0.499,786,1381,0.569,221,636,0.34700000000000003,466,664,0.7020000000000001,379,890,1269,527,207,116,421,635,79.4,0.765,2.26,-3.42,69.3,14.0
100582,881,1938,0.455,563,1055,0.534,318,883,0.36,603,782,0.7709999999999999,316,913,1229,459,180,83,453,584,76.7,0.514,-2.3,-0.66,77.1,16.0
100583,933,2082,0.44799999999999995,613,1245,0.49200000000000005,320,837,0.382,606,859,0.705,386,965,1351,559,189,152,386,581,79.8,0.8,10.49,2.03,71.3,12.0
100584,887,2037,0.435,678,1427,0.475,209,610,0.34299999999999997,573,806,0.711,378,963,1341,507,194,227,393,577,75.2,0.706,14.56,8.82,69.4,5.0
100585,815,1896,0.43,469,975,0.48100000000000004,346,921,0.376,513,660,0.777,286,922,1208,450,147,133,430,581,71.1,0.5429999999999999,13.69,10.72,68.1,9.0
100586,772,1716,0.45,474,927,0.511,298,789,0.37799999999999995,307,416,0.738,247,756,1003,426,200,93,298,482,71.6,0.767,6.57,-1.84,61.4,12.0
100587,943,1909,0.494,714,1288,0.5539999999999999,229,621,0.369,456,651,0.7,326,866,1192,476,199,151,392,555,73.5,0.8290000000000001,6.67,-3.27,62.1,13.0
100588,945,2050,0.461,746,1448,0.515,199,602,0.331,527,747,0.705,386,889,1275,525,263,138,435,728,74.7,0.743,11.57,3.77,66.9,10.0
100589,1071,2231,0.48,735,1314,0.5589999999999999,336,917,0.366,489,708,0.691,422,839,1261,564,234,115,363,699,84.8,0.8290000000000001,8.06,-0.55,75.0,12.0
100590,942,1961,0.48,656,1207,0.5429999999999999,286,754,0.379,497,730,0.6809999999999999,302,901,1203,510,252,134,466,655,76.3,0.743,5.89,-2.48,67.9,13.0
100591,887,1813,0.489,597,1093,0.546,290,720,0.40299999999999997,546,741,0.737,240,828,1068,497,131,91,398,543,79.1,0.667,12.77,8.38,74.7,9.0
100592,827,1840,0.449,555,1083,0.512,272,757,0.359,512,732,0.6990000000000001,351,822,1173,472,180,154,426,613,73.9,0.727,12.79,8.29,68.1,6.0
100593,872,1949,0.447,670,1351,0.496,202,598,0.33799999999999997,471,733,0.643,439,872,1311,405,228,82,449,613,73.2,0.636,12.1,9.25,70.4,9.0
100594,913,1957,0.467,661,1210,0.546,252,747,0.337,600,843,0.7120000000000001,436,903,1339,505,166,128,465,627,78.8,0.8240000000000001,4.66,-3.82,67.9,14.0
100595,982,2153,0.456,671,1286,0.522,311,867,0.359,614,847,0.725,409,953,1362,484,221,129,462,654,78.1,0.595,-0.47,-3.36,72.1,15.0
100596,928,2037,0.456,628,1178,0.5329999999999999,300,859,0.349,503,740,0.68,391,928,1319,486,200,98,468,622,76.0,0.6859999999999999,-0.17,-2.84,71.6,15.0
100597,857,1869,0.45899999999999996,599,1184,0.506,258,685,0.377,462,647,0.7140000000000001,355,889,1244,493,157,134,477,628,69.5,0.5710000000000001,-2.85,-3.24,67.9,15.0
100598,957,2050,0.467,663,1318,0.503,294,732,0.402,620,786,0.789,454,761,1215,486,252,99,432,730,85.7,0.606,19.19,12.22,78.5,10.0
100599,813,1800,0.452,604,1213,0.498,209,587,0.35600000000000004,443,617,0.718,363,813,1176,389,213,125,417,513,69.0,0.636,14.48,9.57,64.1,8.0
100600,866,2015,0.43,661,1322,0.5,205,693,0.29600000000000004,656,893,0.735,401,827,1228,409,250,111,407,607,74.1,0.657,-6.41,-7.81,72.7,16.0
100601,979,2155,0.45399999999999996,637,1293,0.493,342,862,0.397,513,668,0.768,337,913,1250,541,239,108,421,669,80.4,0.629,1.08,-2.47,76.8,14.0
100602,1078,2137,0.504,774,1371,0.565,304,766,0.397,404,592,0.682,289,934,1223,598,213,102,435,582,81.8,0.7140000000000001,17.27,8.95,72.8,6.0
100603,919,1888,0.48700000000000004,583,1105,0.528,336,783,0.429,457,585,0.7809999999999999,280,778,1058,525,231,115,396,620,82.2,0.594,15.26,8.6,75.6,10.0
100604,986,2302,0.428,729,1499,0.486,257,803,0.32,543,755,0.7190000000000001,539,915,1454,449,230,134,465,685,77.0,0.611,0.88,-1.63,73.0,14.0
100605,914,1934,0.473,628,1229,0.511,286,705,0.406,485,696,0.6970000000000001,416,919,1335,566,200,117,377,506,74.3,0.857,18.71,4.45,60.0,6.0
100606,820,1763,0.465,562,1092,0.515,258,671,0.385,530,768,0.69,277,820,1097,500,249,128,376,601,75.9,0.75,12.98,4.27,66.4,7.0
100607,850,2000,0.425,573,1207,0.475,277,793,0.349,445,614,0.725,415,829,1244,442,226,105,441,596,67.3,0.639,-2.61,-4.08,64.9,16.0
100608,884,1959,0.451,629,1298,0.485,255,661,0.386,597,794,0.752,344,864,1208,472,239,118,391,674,77.1,0.765,8.87,2.61,70.8,11.0
100609,832,1995,0.41700000000000004,624,1340,0.466,208,655,0.318,594,807,0.736,442,933,1375,395,258,198,460,611,66.6,0.622,12.89,10.02,63.8,11.0
100610,925,2111,0.43799999999999994,645,1330,0.485,280,781,0.359,657,906,0.725,372,929,1301,438,207,145,453,631,77.4,0.444,-7.53,-5.53,79.4,16.0
100611,910,1975,0.461,681,1273,0.535,229,702,0.326,555,828,0.67,360,930,1290,458,228,192,513,676,72.3,0.556,12.34,10.64,70.6,9.0
100612,1105,2334,0.473,754,1386,0.544,351,948,0.37,486,695,0.6990000000000001,430,958,1388,597,225,146,446,755,84.6,0.75,7.99,0.25,76.2,13.0
100613,1125,2288,0.49200000000000005,816,1457,0.56,309,831,0.37200000000000005,562,791,0.71,496,1023,1519,648,275,185,460,574,84.4,0.784,24.44,9.71,69.6,2.0
100614,893,2065,0.43200000000000005,585,1233,0.474,308,832,0.37,483,673,0.718,367,831,1198,445,237,164,335,591,75.8,0.618,16.67,10.08,69.2,6.0
100615,1125,2261,0.498,797,1370,0.5820000000000001,328,891,0.368,513,725,0.708,413,1064,1477,564,234,134,420,631,83.5,0.865,18.43,2.59,67.7,4.0
100616,952,2066,0.461,655,1298,0.505,297,768,0.387,484,674,0.718,408,944,1352,505,218,106,418,737,76.7,0.7709999999999999,15.99,4.16,64.9,6.0
100617,1165,2366,0.49200000000000005,774,1392,0.556,391,974,0.401,453,640,0.708,381,1007,1388,649,254,160,456,597,81.4,0.795,21.39,11.87,71.9,1.0
100618,998,2115,0.47200000000000003,803,1569,0.512,195,546,0.35700000000000004,649,930,0.698,441,990,1431,489,208,176,480,702,76.8,0.703,17.24,10.73,70.2,5.0
100619,995,1963,0.507,718,1263,0.568,277,700,0.396,454,626,0.725,238,984,1222,594,241,90,472,528,71.6,0.8420000000000001,10.38,1.81,62.6,11.0
100620,1092,2335,0.46799999999999997,731,1324,0.552,361,1011,0.35700000000000004,474,717,0.6609999999999999,345,1022,1367,585,261,126,379,643,73.6,0.805,19.03,9.41,63.3,3.0
100621,951,1980,0.48,712,1302,0.547,239,678,0.353,450,616,0.731,334,911,1245,499,209,132,399,595,76.2,0.735,17.67,9.03,67.6,5.0
100622,954,2096,0.455,718,1426,0.504,236,670,0.35200000000000004,439,630,0.6970000000000001,389,781,1170,520,249,118,362,645,76.0,0.765,11.81,4.61,68.8,7.0
100623,971,2073,0.46799999999999997,721,1388,0.519,250,685,0.365,509,729,0.698,416,886,1302,527,210,117,432,614,79.4,0.647,15.67,10.11,73.9,8.0
100624,885,2012,0.44,612,1294,0.473,273,718,0.38,541,715,0.757,404,858,1262,550,222,156,422,680,73.8,0.743,18.2,10.12,65.7,3.0
100625,964,2096,0.46,712,1394,0.511,252,702,0.359,579,823,0.7040000000000001,407,925,1332,529,262,158,454,669,74.6,0.73,19.38,9.6,64.8,3.0
100626,1220,2440,0.5,756,1282,0.59,464,1158,0.401,559,718,0.779,385,1051,1436,655,259,162,426,645,86.6,0.9,26.64,10.24,70.2,1.0
100627,906,2102,0.431,582,1194,0.48700000000000004,324,908,0.35700000000000004,647,836,0.774,407,883,1290,481,252,180,411,672,81.9,0.765,15.97,7.29,73.2,4.0
100628,1020,2155,0.473,733,1350,0.5429999999999999,287,805,0.35700000000000004,436,562,0.7759999999999999,324,874,1198,489,232,100,391,642,78.9,0.6,16.92,10.55,72.6,10.0
100629,944,2100,0.45,682,1358,0.502,262,742,0.353,523,756,0.6920000000000001,479,934,1413,570,256,194,404,561,74.3,0.861,20.25,3.53,57.5,2.0
100630,899,1971,0.456,611,1185,0.516,288,786,0.366,498,660,0.755,313,943,1256,463,198,169,414,564,73.8,0.7140000000000001,17.17,9.25,65.9,5.0
100631,994,2125,0.46799999999999997,721,1344,0.536,273,781,0.35,543,786,0.691,398,924,1322,523,241,186,456,652,80.2,0.657,15.79,8.5,72.9,9.0
100632,937,2025,0.46299999999999997,683,1280,0.534,254,745,0.341,502,684,0.7340000000000001,304,832,1136,510,294,110,423,684,71.1,0.6759999999999999,12.84,8.74,67.0,9.0
100633,1042,2232,0.467,680,1220,0.557,362,1012,0.358,571,747,0.764,293,994,1287,615,252,209,476,617,83.8,0.6940000000000001,4.21,0.44,79.1,13.0
100634,991,1996,0.496,701,1271,0.552,290,725,0.4,535,716,0.747,405,1034,1439,670,143,251,459,640,80.2,0.857,22.41,7.1,64.9,3.0
100635,1049,2238,0.469,695,1334,0.521,354,904,0.392,603,812,0.743,342,974,1316,598,230,150,357,630,82.6,0.784,14.44,4.93,73.1,7.0
100636,1105,2417,0.457,800,1568,0.51,305,849,0.359,503,677,0.743,511,1059,1570,674,213,151,445,587,81.6,0.703,20.08,11.78,73.3,2.0
100637,1033,2097,0.493,680,1257,0.541,353,840,0.42,555,747,0.743,319,976,1295,598,211,180,399,580,80.4,0.8109999999999999,23.41,8.74,65.7,2.0
100638,976,2121,0.46,746,1421,0.525,230,700,0.32899999999999996,449,679,0.6609999999999999,432,1018,1450,538,190,209,476,574,75.2,0.629,15.3,10.62,70.5,7.0
100639,926,2088,0.44299999999999995,562,1148,0.49,364,940,0.387,414,641,0.6459999999999999,348,897,1245,547,269,87,440,592,73.1,0.6940000000000001,-2.02,-3.84,68.5,16.0
100640,1036,2374,0.436,714,1463,0.488,322,911,0.353,570,744,0.7659999999999999,521,880,1401,561,301,192,420,798,80.1,0.703,19.88,9.36,69.6,5.0
100641,1011,2055,0.49200000000000005,737,1319,0.5589999999999999,274,736,0.37200000000000005,657,843,0.779,345,997,1342,579,205,109,441,602,84.4,0.8290000000000001,19.08,9.45,74.7,1.0
100642,935,2055,0.455,656,1240,0.529,279,815,0.342,547,786,0.696,370,957,1327,442,194,111,496,687,77.0,0.514,-8.61,-8.19,76.4,16.0
100643,927,2014,0.46,617,1201,0.514,310,813,0.381,515,715,0.72,337,946,1283,495,184,131,399,592,81.2,0.636,12.07,6.86,76.0,11.0
100644,888,1920,0.46299999999999997,600,1127,0.532,288,793,0.363,581,793,0.733,315,811,1126,458,209,114,343,604,82.7,0.625,14.37,6.56,74.8,11.0
100645,949,2060,0.461,737,1420,0.519,212,640,0.331,410,597,0.687,415,921,1336,545,179,117,495,650,72.0,0.5429999999999999,-13.19,-12.31,69.3,16.0
100646,931,1865,0.499,642,1120,0.573,289,745,0.38799999999999996,483,681,0.7090000000000001,246,832,1078,542,191,74,395,523,79.8,0.636,14.35,6.72,72.2,8.0
100647,1009,2003,0.504,772,1361,0.5670000000000001,237,642,0.369,563,741,0.76,353,924,1277,531,173,158,426,603,80.5,0.7709999999999999,15.67,6.84,71.7,4.0
100648,957,2076,0.461,633,1230,0.515,324,846,0.38299999999999995,462,626,0.738,291,855,1146,542,229,103,395,587,79.5,0.588,0.76,-2.19,76.5,15.0
100649,924,2075,0.445,593,1137,0.522,331,938,0.353,383,549,0.698,418,889,1307,487,267,132,481,650,73.2,0.7709999999999999,4.54,-3.87,62.5,13.0
100650,902,1967,0.45899999999999996,663,1258,0.527,239,709,0.337,502,702,0.715,366,884,1250,488,206,107,394,564,77.1,0.667,12.23,3.91,67.9,11.0
100651,893,1948,0.45799999999999996,602,1117,0.539,291,831,0.35,429,651,0.659,283,956,1239,508,194,92,391,566,75.9,0.727,2.24,-3.17,68.9,16.0
100652,899,1874,0.48,546,967,0.565,353,907,0.389,368,461,0.7979999999999999,229,849,1078,551,155,65,315,503,76.3,0.636,11.02,2.57,67.9,12.0
100653,875,1881,0.465,628,1203,0.522,247,678,0.364,362,547,0.662,318,795,1113,424,210,130,367,518,73.8,0.688,12.83,6.96,67.9,6.0
100654,944,2021,0.467,758,1472,0.515,186,549,0.33899999999999997,551,780,0.706,402,856,1258,428,264,114,422,716,77.2,0.765,6.28,-2.25,68.5,14.0
100655,1003,2147,0.467,629,1220,0.516,374,927,0.40299999999999997,578,759,0.762,310,1050,1360,467,172,80,353,562,84.5,0.8,6.84,-0.38,74.3,12.0
100656,954,2063,0.462,654,1227,0.5329999999999999,300,836,0.359,510,684,0.746,339,890,1229,479,208,151,428,551,84.9,0.563,13.81,10.56,81.7,10.0
100657,965,2054,0.47,702,1347,0.521,263,707,0.37200000000000005,489,703,0.696,401,775,1176,531,244,122,400,609,81.3,0.636,12.91,6.7,75.1,9.0
100658,873,2019,0.43200000000000005,636,1316,0.483,237,703,0.337,517,723,0.715,356,910,1266,460,231,77,459,558,71.4,0.7140000000000001,0.58,-3.64,65.9,14.0
100659,1000,2059,0.486,758,1408,0.5379999999999999,242,651,0.37200000000000005,577,819,0.705,402,846,1248,498,361,107,540,765,80.5,0.8,2.67,-6.46,68.2,14.0
100660,875,1905,0.45899999999999996,616,1185,0.52,259,720,0.36,527,699,0.754,286,843,1129,387,177,119,339,563,74.6,0.765,1.83,-3.29,68.6,13.0
100661,1005,2119,0.474,736,1438,0.512,269,681,0.395,540,793,0.6809999999999999,351,857,1208,501,218,163,381,700,80.5,0.657,14.76,9.85,75.6,7.0
100662,937,2033,0.461,614,1194,0.514,323,839,0.385,417,615,0.6779999999999999,309,873,1182,455,256,160,395,639,74.7,0.6859999999999999,3.23,-2.78,67.3,15.0
100663,963,2104,0.45799999999999996,705,1331,0.53,258,773,0.33399999999999996,388,603,0.643,427,975,1402,481,189,103,429,604,75.6,0.8240000000000001,9.06,-1.1,64.2,12.0
100664,794,1765,0.45,488,966,0.505,306,799,0.38299999999999995,505,688,0.7340000000000001,333,892,1225,443,170,140,469,594,72.7,0.606,13.81,9.19,68.1,8.0
100665,1008,2050,0.49200000000000005,665,1127,0.59,343,923,0.37200000000000005,397,531,0.748,249,957,1206,588,187,88,371,501,83.5,0.636,16.35,8.1,74.1,8.0
100666,957,2009,0.47600000000000003,657,1222,0.5379999999999999,300,787,0.381,517,700,0.7390000000000001,405,931,1336,610,154,127,385,580,82.8,0.758,16.58,5.46,71.6,4.0
100667,965,2050,0.47100000000000003,685,1246,0.55,280,804,0.348,627,872,0.7190000000000001,325,956,1281,505,194,152,437,655,81.1,0.7140000000000001,4.48,-3.46,73.1,14.0
100668,882,2010,0.439,637,1244,0.512,245,766,0.32,441,663,0.665,361,856,1217,394,209,168,399,547,72.1,0.5589999999999999,13.96,10.67,68.8,10.0
100669,924,2040,0.45299999999999996,657,1227,0.535,267,813,0.32799999999999996,593,826,0.718,346,930,1276,517,216,102,493,656,82.1,0.6970000000000001,-2.1,-3.8,77.7,15.0
100670,804,1721,0.467,637,1221,0.522,167,500,0.33399999999999996,543,745,0.7290000000000001,280,843,1123,403,201,106,455,578,72.4,0.625,-0.92,-1.02,70.2,15.0
100671,979,1973,0.496,705,1279,0.551,274,694,0.395,476,674,0.706,368,833,1201,615,214,119,419,553,82.1,0.636,16.38,9.68,75.4,6.0
100672,899,2037,0.441,676,1366,0.495,223,671,0.332,554,787,0.7040000000000001,369,878,1247,485,238,128,430,624,73.6,0.6,11.12,10.23,72.7,10.0
100673,848,1844,0.46,601,1199,0.501,247,645,0.38299999999999995,340,451,0.754,282,817,1099,458,232,124,290,480,67.1,0.912,22.21,9.07,54.0,1.0
100674,870,1803,0.483,599,1084,0.5529999999999999,271,719,0.377,504,687,0.7340000000000001,341,845,1186,471,216,104,384,559,78.6,0.813,6.87,-3.53,66.2,12.0
